Date,Description,Debit,Credit,Balance,Category,SubCategory
31/10/2024,Visa Purchase                 28Oct Smp*Baskin Robbins H Hamilton,15.76,,12857.55,Food & Beverage,Dining out
31/10/2024,Internet Deposit              31Oct05:56 From 0280074494440,,800,12873.31,Deposits,Deposit
30/10/2024,Visa Credit                   26Oct Beach Cafe 2         Tangaloom,,25,12073.31,Deposits,Deposit
30/10/2024,Visa Purchase                 28Oct Gelatomessinakenttow Brisbane,95,,12048.31,Food & Beverage,Food & Groceries
30/10/2024,Visa Purchase                 26Oct Beach Cafe 2         Tangaloom,49,,12143.31,Food & Beverage,Dining out
30/10/2024,Visa Purchase                 27Oct Telstra Prepaid      Melbourne,39,,12192.31,Bills & Payments,Telecommunications
30/10/2024,Visa Purchase                 26Oct Coffee Shop 1        Tangaloom,15.5,,12231.31,Food & Beverage,Beverages
30/10/2024,Visa Purchase                 26Oct Tangalooma 6         Tangaloom,14.5,,12246.81,Transport & Travel,Hotels and Accommodation
30/10/2024,Visa Purchase                 26Oct Tangalife Pty Ltd    Moreton I,10,,12261.31,Transport & Travel,Holidays
30/10/2024,Visa Purchase                 26Oct Tangalooma 6         Tangaloom,10,,12271.31,Transport & Travel,Hotels and Accommodation
30/10/2024,Visa Purchase                 26Oct Tangalooma 5         Tangaloom,10,,12281.31,Transport & Travel,Hotels and Accommodation
30/10/2024,Visa Purchase                 26Oct Tangalooma 5         Tangaloom,10,,12291.31,Transport & Travel,Hotels and Accommodation
30/10/2024,Visa Purchase                 26Oct Shop 2               Tangaloom,9.95,,12301.31,Bills & Payments,Gifts & Donations
30/10/2024,Andrew Kay Manag Wages 27102024,,1643.61,12311.26,Income,Salary
29/10/2024,Visa Purchase                 27Oct Felons Barrel Hall   Corinda,61.53,,10667.65,Food & Beverage,Beverages
29/10/2024,Visa Purchase                 25Oct Zlr*Choo Choo Sushi  Hamilton,42.64,,10729.18,Food & Beverage,Dining out
29/10/2024,Visa Purchase                 27Oct Ls Short Stop Coffee Hamilton,25.85,,10771.82,Food & Beverage,Beverages
29/10/2024,Visa Purchase                 25Oct Smp*Baskin Robbins H Hamilton,9.66,,10797.67,Food & Beverage,Dining out
29/10/2024,Visa Purchase                 24Oct Iga Portside Wharf   Hamilton,5.85,,10807.33,Food & Beverage,Food & Groceries
28/10/2024,Visa Purchase                 25Oct Ls Rise Bakery       Hamilton,30.39,,10813.18,Food & Beverage,Food & Groceries
28/10/2024,Eftpos Debit                  27Oct17:24 Uber* Trip\,32.58,,10843.57,Transport & Travel,Taxi & Rental car
28/10/2024,Eftpos Debit                  27Oct09:26 Uber* Trip\,24.69,,10876.15,Transport & Travel,Taxi & Rental car
28/10/2024,Eftpos Debit                  26Oct22:41 Uber* Trip\,47.16,,10900.84,Transport & Travel,Taxi & Rental car
26/10/2024,Visa Purchase                 24Oct Amazon Marketplace A Sydney So,63.99,,10948,Retail & Personal,Retail (shopping)
26/10/2024,Visa Purchase                 22Oct Iga Portside Wharf   Hamilton,16.4,,11011.99,Food & Beverage,Food & Groceries
26/10/2024,Visa Purchase                 24Oct Vending Simplicity   Wakerley,2.8,,11028.39,Food & Beverage,Beverages
26/10/2024,Visa Purchase                 24Oct Vending Simplicity   Wakerley,2.5,,11031.19,Food & Beverage,Beverages
26/10/2024,Eftpos Debit                  26Oct21:57 Uber* Trip\,5.5,,11033.69,Transport & Travel,Taxi & Rental car
26/10/2024,Eftpos Debit                  26Oct10:39 Uber* Trip\,46.5,,11039.19,Transport & Travel,Taxi & Rental car
26/10/2024,Eftpos Debit                  26Oct10:07 Uber* Trip\,14.78,,11085.69,Transport & Travel,Taxi & Rental car
25/10/2024,Visa Purchase                 22Oct Riva Kitchen & Event Hamilton,62.12,,11100.47,Food & Beverage,Dining out
25/10/2024,Visa Purchase                 21Oct Iga Portside Wharf   Hamilton,10.83,,11162.59,Food & Beverage,Food & Groceries
25/10/2024,Visa Purchase                 22Oct Ls The Ballpark Port Hamilton,10,,11173.42,Food & Beverage,Dining out
24/10/2024,Visa Purchase                 21Oct Sp Usafoods Aus      Moorabbin,73.46,,11183.42,Home & Property,Technology & Appliances
24/10/2024,Visa Purchase                 21Oct Smp*Baskin Robbins H Hamilton,15.76,,11256.88,Food & Beverage,Dining out
24/10/2024,Visa Purchase                 21Oct Smp*Baskin Robbins H Hamilton,2.03,,11272.64,Food & Beverage,Dining out
24/10/2024,Internet Deposit              24Oct06:00 From 0280074494440,,800,11274.67,Deposits,Deposit
23/10/2024,Visa Purchase                 21Oct Officeworks          Bentleigh,13.18,,10474.67,Retail & Personal,Retail (shopping)
23/10/2024,Visa Purchase                 18Oct Tobern Investments P Adelaide,12.5,,10487.85,Food & Beverage,Beverages
23/10/2024,Visa Purchase                 18Oct Tobern Investments P Adelaide,9.5,,10500.35,Food & Beverage,Beverages
23/10/2024,Visa Purchase                 19Oct Nth Adel Foodland    North Ade,7.38,,10509.85,Food & Beverage,Food & Groceries
23/10/2024,Andrew Kay Manag Wages 20102024,,1366.5,10517.23,Income,Salary
23/10/2024,Tfr Wdl BPAY Internet         23Oct05:46 0207782150          Sa Water,175.01,,9150.73,Bills & Payments,Utilities & Rates
22/10/2024,Visa Purchase                 20Oct Woolworths Online    Bella Vis,102.9,,9325.74,Food & Beverage,Food & Groceries
22/10/2024,Visa Purchase                 19Oct Ll Mexican Restauran North Ade,37.8,,9428.64,Food & Beverage,Dining out
22/10/2024,Visa Purchase                 19Oct Crown And Anchor Hot Adelaide,17.77,,9466.44,Food & Beverage,Dining out
22/10/2024,Visa Purchase                 19Oct Bakery On O'Connell  North Ade,12.12,,9484.21,Food & Beverage,Food & Groceries
22/10/2024,Visa Purchase                 20Oct Woolworths Online    Bella Vis,6,,9496.33,Food & Beverage,Food & Groceries
22/10/2024,Visa Purchase                 18Oct Bakery On O'Connell  North Ade,5.35,,9502.33,Food & Beverage,Food & Groceries
21/10/2024,Visa Purchase                 18Oct Iramadison           Httpsiram,75,,9507.68,Retail & Personal,Medical & Personal care
21/10/2024,Visa Purchase                 18Oct Prestige Dry Clean   North Ade,66,,9582.68,Home & Property,Services & Tradespeople
21/10/2024,Visa Purchase                 17Oct Mitolo Coffee        Welland,27.68,,9648.68,Food & Beverage,Beverages
21/10/2024,Visa Purchase                 18Oct Neuronau* Temphold-3 Hawthorn,5.59,,9676.36,Transport & Travel,Vehicle Expenses
21/10/2024,Visa Purchase                 18Oct Neuronau* Temphold-V Hawthorn,2.53,,9681.95,Transport & Travel,Vehicle Expenses
21/10/2024,Eftpos Debit                  21Oct13:16 Uber* Trip\,30.21,,9684.48,Transport & Travel,Taxi & Rental car
21/10/2024,Eftpos Debit                  21Oct09:18 Uber* Trip\,35.92,,9714.69,Transport & Travel,Taxi & Rental car
21/10/2024,Eftpos Credit                 21Oct08:26 Uber* Trip\,,35.92,9750.61,Deposits,Deposit
21/10/2024,Tfr Wdl BPAY Internet         21Oct05:41 500015101768        Origin Energy,2090,,9714.69,Bills & Payments,Utilities & Rates
21/10/2024,Eftpos Debit                  20Oct20:25 Uber* Trip\,35.92,,11804.69,Transport & Travel,Taxi & Rental car
21/10/2024,Eftpos Debit                  20Oct13:25 Color Club Pty Ltd    North Adelaidsa Au,21,,11840.61,Retail & Personal,Retail (shopping)
21/10/2024,Eftpos Debit                  19Oct23:37 Uber* Trip\,13.58,,11861.61,Transport & Travel,Taxi & Rental car
19/10/2024,Visa Purchase                 16Oct Costco Wholesale Aus Kilburn,141.91,,11875.19,Food & Beverage,Food & Groceries
19/10/2024,Visa Purchase                 17Oct Aware Women's Health North Ade,105,,12017.1,Retail & Personal,Medical & Personal care
19/10/2024,Visa Purchase                 17Oct Aust Federal Police  Sydney,56.29,,12122.1,Bills & Payments,Professional & Govt services
19/10/2024,Visa Purchase                 17Oct Lucia's Fine Foods   Adelaide,17.19,,12178.39,Food & Beverage,Food & Groceries
19/10/2024,Visa Purchase                 16Oct Bakery On O'Connell  North Ade,13.13,,12195.58,Food & Beverage,Food & Groceries
19/10/2024,Visa Purchase                 17Oct Bobo & Associates Pt Adelaide,8,,12208.71,Retail & Personal,Retail (shopping)
18/10/2024,Visa Purchase                 16Oct Ls Frankly Coffee An Prospect,16,,12216.71,Food & Beverage,Beverages
18/10/2024,Eftpos Debit                  18Oct20:45 Uber* Trip\,11.7,,12232.71,Transport & Travel,Taxi & Rental car
17/10/2024,Visa Purchase                 15Oct Nth Adel Foodland    North Ade,5.12,,12244.41,Food & Beverage,Food & Groceries
17/10/2024,Mcare Benefits 928177555 Gywq,,42.85,12249.53,Government payments,Centrelink payments
17/10/2024,Andrew Kay Manag Wages 13102024,,1198,12206.68,Income,Salary
17/10/2024,Internet Deposit              17Oct05:57 From 0280074494440,,800,11008.68,Deposits,Deposit
16/10/2024,Visa Purchase                 13Oct Nth Adel Foodland    North Ade,18.18,,10208.68,Food & Beverage,Food & Groceries
16/10/2024,Visa Purchase                 12Oct Zambrero Nth Adl     North Ade,14.9,,10226.86,Food & Beverage,Dining out
16/10/2024,Visa Purchase                 12Oct Nth Adel Foodland    North Ade,8.54,,10241.76,Food & Beverage,Food & Groceries
16/10/2024,Eftpos Debit                  16Oct17:00 Color Club Pty Ltd    North Adelaidsa Au,56,,10250.3,Retail & Personal,Retail (shopping)
15/10/2024,Visa Purchase                 13Oct Gn Circleoffriendsa  Summertow,51.63,,10306.3,Bills & Payments,Gifts & Donations
15/10/2024,Visa Purchase                 11Oct Bakery On O'Connell  North Ade,18.18,,10357.93,Food & Beverage,Food & Groceries
15/10/2024,Visa Purchase                 12Oct Bakery On O'Connell  North Ade,15.66,,10376.11,Food & Beverage,Food & Groceries
15/10/2024,Visa Purchase                 12Oct Regency Park Rotary  North Ade,5.5,,10391.77,Bills & Payments,Gifts & Donations
15/10/2024,Visa Purchase                 13Oct Neuronau* Temphold-F Hawthorn,5.08,,10397.27,Transport & Travel,Vehicle Expenses
15/10/2024,Osko Withdrawal               15Oct18:09 Syd Accom Jodi Godby,300,,10402.35,Withdrawals & Transfers,Withdrawal
14/10/2024,Visa Purchase                 11Oct Krung Thep           North Ade,122,,10702.35,Food & Beverage,Dining out
14/10/2024,Visa Purchase                 11Oct Nth Adel Foodland    North Ade,42.85,,10824.35,Food & Beverage,Food & Groceries
14/10/2024,Visa Purchase                 10Oct Color Club Pty Ltd   North Ade,25.25,,10867.2,Retail & Personal,Retail (shopping)
14/10/2024,Visa Purchase                 11Oct Zlr*Haru Sushi       North Ade,10.5,,10892.45,Food & Beverage,Dining out
14/10/2024,Eftpos Debit                  14Oct09:31 Bakery On O'Connell   North Adelaidsa Au,17.47,,10902.95,Food & Beverage,Food & Groceries
14/10/2024,Eftpos Debit                  13Oct14:34 Neuronau* Trip-Kb\,6.61,,10920.42,Transport & Travel,Vehicle Expenses
12/10/2024,Visa Purchase                 10Oct Elysian Salon & Spa  Adelaide,393.35,,10927.03,Retail & Personal,Retail (shopping)
12/10/2024,Visa Purchase                 10Oct Nth Adel Foodland    North Ade,16.15,,11320.38,Food & Beverage,Food & Groceries
12/10/2024,Visa Purchase                 09Oct Bakery On O'Connell  North Ade,15.66,,11336.53,Food & Beverage,Food & Groceries
12/10/2024,Visa Purchase                 10Oct Les Deux Coqs Pty Lt Adelaide,15.64,,11352.19,Food & Beverage,Food & Groceries
12/10/2024,Visa Purchase                 09Oct Mcdonalds Collinswoo Collinswo,13.35,,11367.83,Food & Beverage,Dining out
12/10/2024,Visa Purchase                 09Oct Bakery On O'Connell  North Ade,11.11,,11381.18,Food & Beverage,Food & Groceries
11/10/2024,Visa Purchase                 09Oct South Australia Poli Holden Hi,159,,11392.29,Bills & Payments,Professional & Govt services
11/10/2024,Foreign Currency Conversn Fee,2.05,,11551.29,Fees & Charges,Fees & Charges
11/10/2024,Visa Purchase O/Seas          09Oct Sgd60.00 Spf E03897024,68.52,,11553.34,Bills & Payments,Professional & Govt services
11/10/2024,Visa Purchase                 08Oct Bakery On O'Connell  North Ade,24.24,,11621.86,Food & Beverage,Food & Groceries
11/10/2024,Visa Purchase                 09Oct Prestige Dry Clean   North Ade,16,,11646.1,Home & Property,Services & Tradespeople
11/10/2024,Foreign Currency Conversn Fee,0.16,,11662.1,Fees & Charges,Fees & Charges
11/10/2024,Visa Purchase O/Seas          07Oct Sgd4.99 Amznprimesg Membersh,5.64,,11662.26,Entertainment & Recreation,TV
11/10/2024,Visa Purchase                 09Oct V/Cellars 3327       N Adelaid,0.2,,11667.9,Food & Beverage,Beverages
11/10/2024,Tfr Wdl BPAY Internet         11Oct06:01 500015101776        Origin Energy,228.11,,11668.1,Bills & Payments,Utilities & Rates
10/10/2024,Eftpos Debit                  10Oct12:39 Neuronau* Trip-Kg\,7.63,,11896.21,Transport & Travel,Vehicle Expenses
10/10/2024,Eftpos Debit                  10Oct09:25 Neuronau* Trip-Tv\,6.1,,11903.84,Transport & Travel,Vehicle Expenses
10/10/2024,Internet Deposit              10Oct06:00 From 0280074494440,,800,11909.94,Deposits,Deposit
9/10/2024,Visa Purchase                 07Oct Far Eastern Dept. 00 Taipei Ci,140.61,,11109.94,Food & Beverage,Dining out
9/10/2024,Andrew Kay Manag Wages 06102024,,617,11250.55,Income,Salary
8/10/2024,Foreign Currency Conversn Fee,3.42,,10633.55,Fees & Charges,Fees & Charges
8/10/2024,Visa Purchase O/Seas          04Oct Twd2500.00 Taiwan High Speed Ra,114.29,,10636.97,Bills & Payments,Freight & Postage
8/10/2024,Visa Cash Advance             05Oct Cathay United Bank   Taipei,95.34,,10751.26,Withdrawals & Transfers,Funds transfer
8/10/2024,Foreign Currency Conversn Fee,0.82,,10846.6,Fees & Charges,Fees & Charges
8/10/2024,Visa Purchase O/Seas          06Oct Twd600.00 Taipei 101,27.37,,10847.42,Entertainment & Recreation,Attractions
8/10/2024,Visa Purchase                 04Oct Telstra Prepaid      Melbourne,25,,10874.79,Bills & Payments,Telecommunications
8/10/2024,Visa Purchase                 05Oct Uniqlo               Taipei Ci,9.36,,10899.79,Retail & Personal,Clothing & Shoes
8/10/2024,Eftpos Debit                  08Oct15:57 Uber* Trip\,31.84,,10909.15,Transport & Travel,Taxi & Rental car
4/10/2024,Foreign Currency Conversn Fee,1.21,,10940.99,Fees & Charges,Fees & Charges
4/10/2024,Visa Purchase O/Seas          02Oct Twd884.00 Wellcome-A0,40.45,,10942.2,Food & Beverage,Food & Groceries
3/10/2024,Visa Cash Advance             01Oct Cathay United Bank   Taipei,144.2,,10982.65,Withdrawals & Transfers,Funds transfer
3/10/2024,Visa Cash Advance             02Oct Cathay United Bank   Taipei,143.05,,11126.85,Withdrawals & Transfers,Funds transfer
3/10/2024,Visa Purchase                 01Oct Patreon* Membership  Internet,36.85,,11269.9,Entertainment & Recreation,TV
3/10/2024,Visa Purchase                 30Sep Telstra Prepaid      Melbourne,35,,11306.75,Bills & Payments,Telecommunications
3/10/2024,Visa Purchase                 30Sep Telstra Prepaid      Melbourne,25,,11341.75,Bills & Payments,Telecommunications
2/10/2024,Visa Purchase                 30Sep Brow Threads & Lashe Salisbury,20.26,,11366.75,Retail & Personal,Retail (shopping)
2/10/2024,Visa Purchase                 29Sep Color Club Pty Ltd   North Ade,20.2,,11387.01,Retail & Personal,Retail (shopping)
2/10/2024,Visa Purchase                 30Sep Beam Mobility Austra -,6.12,,11407.21,Bills & Payments,Telecommunications
2/10/2024,Visa Purchase                 30Sep Beam Mobility Austra -,2.02,,11413.33,Bills & Payments,Telecommunications
2/10/2024,Andrew Kay Manag Wages 29092024,,1366.5,11415.35,Income,Salary
2/10/2024,Internet Deposit              02Oct12:49 From 9000204517840,,50,10048.85,Deposits,Deposit
2/10/2024,Internet Deposit              02Oct12:47 From 9000204517840,,5000,9998.85,Deposits,Deposit
1/10/2024,Visa Purchase                 29Sep Sq *Prospect Communi Prospect,20,,4998.85,Food & Beverage,Food & Groceries
1/10/2024,Visa Purchase                 29Sep Sq *Komodo Van       Prospect,18,,5018.85,Food & Beverage,Food & Groceries
1/10/2024,Visa Purchase                 29Sep Sq *Village Asian Gr North Ade,11.6,,5036.85,Food & Beverage,Food & Groceries
1/10/2024,Visa Purchase                 29Sep Sq *Prospect Communi Prospect,10,,5048.45,Food & Beverage,Food & Groceries
1/10/2024,Visa Purchase                 29Sep Sq *Prospect Communi Prospect,9,,5058.45,Food & Beverage,Food & Groceries
1/10/2024,Visa Purchase                 28Sep Bakery On O'Connell  North Ade,6.87,,5067.45,Food & Beverage,Food & Groceries
1/10/2024,Eftpos Debit                  01Oct01:32 Hugh Hamilton Wines\,340,,5074.32,Bills & Payments,Gifts & Donations
30/09/2024,Visa Purchase                 27Sep Zlr*St George's Bake Adelaide,12.4,,5414.32,Food & Beverage,Food & Groceries
30/09/2024,Visa Purchase                 26Sep Brighton & Seacliff  Seacliff,11.8,,5426.72,Food & Beverage,Dining out
30/09/2024,Eftpos Debit                  30Sep09:43 Uber   *Trip Help.Uber.Com\,27.52,,5438.52,Transport & Travel,Taxi & Rental car
30/09/2024,Eftpos Debit                  30Sep15:10 Neuronau* Trip-Ss\,6.61,,5466.04,Transport & Travel,Vehicle Expenses
30/09/2024,Eftpos Debit                  29Sep17:20 Uber* Trip\,12.75,,5472.65,Transport & Travel,Taxi & Rental car
28/09/2024,Visa Purchase                 26Sep Brighton & Seacliff  Seacliff,51,,5485.4,Food & Beverage,Dining out
28/09/2024,Visa Purchase                 26Sep Sq *Beauty On O'Conn North Ade,45,,5536.4,Retail & Personal,Retail (shopping)
28/09/2024,Visa Purchase                 25Sep Bakery On O'Connell  North Ade,35.05,,5581.4,Food & Beverage,Food & Groceries
28/09/2024,Visa Purchase                 26Sep Brighton & Seacliff  Seacliff,22.8,,5616.45,Food & Beverage,Dining out
28/09/2024,Visa Purchase                 26Sep Zambrero Nth Adl     North Ade,14.9,,5639.25,Food & Beverage,Dining out
28/09/2024,Visa Purchase                 26Sep Nth Adel Foodland    North Ade,9.56,,5654.15,Food & Beverage,Food & Groceries
28/09/2024,Visa Purchase                 26Sep Beam Mobility Austra -,3.04,,5663.71,Bills & Payments,Telecommunications
27/09/2024,Deft Payments Deft      24611004,942.99,,5666.75,Bills & Payments,Expenses & Payments
27/09/2024,Visa Purchase                 24Sep Ticketek Web         Sydney,805.3,,6609.74,Entertainment & Recreation,Attractions
27/09/2024,Visa Purchase                 24Sep Bakery On O'Connell  North Ade,15.15,,7415.04,Food & Beverage,Food & Groceries
25/09/2024,Foreign Currency Conversn Fee,0.79,,7430.19,Fees & Charges,Fees & Charges
25/09/2024,Visa Purchase O/Seas          23Sep Usd18.00 Fbi Identification R,26.49,,7430.98,Bills & Payments,Professional & Govt services
25/09/2024,Visa Purchase                 23Sep Sq *Village Asian Gr North Ade,24.7,,7457.47,Food & Beverage,Food & Groceries
25/09/2024,Visa Purchase                 22Sep Nth Adel Foodland    North Ade,24.22,,7482.17,Food & Beverage,Food & Groceries
25/09/2024,Visa Purchase                 22Sep Bakery On O'Connell  North Ade,15.15,,7506.39,Food & Beverage,Food & Groceries
25/09/2024,Visa Purchase                 23Sep Zlr*Haru Sushi       North Ade,10.2,,7521.54,Food & Beverage,Dining out
25/09/2024,Andrew Kay Manag Wages 22092024,,922,7531.74,Income,Salary
24/09/2024,Visa Purchase                 19Sep Targett Medical Pty  North Ade,921.33,,6609.74,Retail & Personal,Retail (shopping)
24/09/2024,Visa Purchase                 22Sep Sq *Graham F Smith P North Ade,20,,7531.07,Bills & Payments,Memberships
24/09/2024,Visa Purchase                 22Sep Sq *Graham F Smith P North Ade,15,,7551.07,Bills & Payments,Memberships
24/09/2024,Visa Purchase                 21Sep Sq *Woodville Concer Croydon P,2,,7566.07,Food & Beverage,Dining out
24/09/2024,Osko Withdrawal               24Sep18:17 10032925 Betta Home Furnishings,267.5,,7568.07,Withdrawals & Transfers,Withdrawal
23/09/2024,Visa Purchase                 20Sep Krung Thep           North Ade,82.35,,7835.57,Food & Beverage,Dining out
23/09/2024,Visa Purchase                 19Sep House Of Health Coll Adelaide,18.8,,7917.92,Food & Beverage,Food & Groceries
23/09/2024,Visa Purchase                 20Sep Krung Thep           North Ade,14,,7936.72,Food & Beverage,Dining out
23/09/2024,Visa Purchase                 19Sep Charlesworth Nuts Pt Adelaide,12.4,,7950.72,Food & Beverage,Food & Groceries
23/09/2024,Visa Purchase                 19Sep Hong Kong Grocery St Adelaide,10.69,,7963.12,Food & Beverage,Food & Groceries
23/09/2024,Visa Purchase                 19Sep North Adelaide News  North Ade,9.9,,7973.81,Entertainment & Recreation,Books & Subscriptions
23/09/2024,Visa Purchase                 20Sep Beam Mobility Austra -,4.57,,7983.71,Bills & Payments,Telecommunications
23/09/2024,Eftpos Debit                  21Sep23:08 Uber* Trip\,1.86,,7988.28,Transport & Travel,Taxi & Rental car
21/09/2024,Visa Purchase                 18Sep Costco Wholesale Aus Kilburn,114.75,,7990.14,Food & Beverage,Food & Groceries
21/09/2024,Visa Purchase                 18Sep Costco Wholesale Aus Kilburn,65,,8104.89,Food & Beverage,Food & Groceries
21/09/2024,Visa Purchase                 19Sep Nth Adel Foodland    North Ade,22.3,,8169.89,Food & Beverage,Food & Groceries
21/09/2024,Visa Purchase                 19Sep Lucia's Fine Foods   Adelaide,17.19,,8192.19,Food & Beverage,Food & Groceries
21/09/2024,Visa Purchase                 19Sep Jeff Ramsey Pharmaci North Ade,14.99,,8209.38,Retail & Personal,Medical & Personal care
21/09/2024,Visa Purchase                 19Sep Sq *Village Asian Gr North Ade,12.14,,8224.37,Food & Beverage,Food & Groceries
21/09/2024,Visa Purchase                 19Sep Cappos Fish Market   Adelaide,12.1,,8236.51,Food & Beverage,Food & Groceries
21/09/2024,Visa Purchase                 19Sep Bobo & Associates Pt Adelaide,8.5,,8248.61,Retail & Personal,Retail (shopping)
21/09/2024,Eftpos Credit                 21Sep14:46 Uber* Trip\,,0.01,8257.11,Deposits,Deposit
21/09/2024,Eftpos Debit                  21Sep14:30 Uber* Trip\,15.49,,8257.1,Transport & Travel,Taxi & Rental car
21/09/2024,Eftpos Debit                  21Sep12:08 Uber* Trip\,15.99,,8272.59,Transport & Travel,Taxi & Rental car
20/09/2024,Visa Purchase                 17Sep Color Club Pty Ltd   North Ade,75.75,,8288.58,Retail & Personal,Retail (shopping)
20/09/2024,Visa Purchase                 18Sep Nth Adel Foodland    North Ade,21.95,,8364.33,Food & Beverage,Food & Groceries
20/09/2024,Eftpos Debit                  20Sep15:22 Neuronau* Trip-Z3\,6.61,,8386.28,Transport & Travel,Vehicle Expenses
20/09/2024,Eftpos Debit                  20Sep09:32 Bakery On O'Connell   North Adelaidsa Au,12.02,,8392.89,Food & Beverage,Food & Groceries
19/09/2024,Visa Purchase                 17Sep Usafoods Aus         Moorabbin,45.88,,8404.91,Home & Property,Technology & Appliances
19/09/2024,Visa Purchase                 17Sep Prestige Dry Clean   North Ade,22,,8450.79,Home & Property,Services & Tradespeople
19/09/2024,Visa Purchase                 16Sep Bakery On O'Connell  North Ade,19.19,,8472.79,Food & Beverage,Food & Groceries
19/09/2024,Visa Purchase                 16Sep Bakery On O'Connell  North Ade,11.11,,8491.98,Food & Beverage,Food & Groceries
19/09/2024,Mcare Benefits 908169934 Gywq,,42.85,8503.09,Government payments,Centrelink payments
19/09/2024,Eftpos Debit                  19Sep10:29 Pro Health Care North North Adelaidsa Au,90.22,,8460.24,Retail & Personal,Medical & Personal care
19/09/2024,Tfr Wdl BPAY Internet         19Sep05:58 5092458412          Revsa - Esl,139.75,,8550.46,Bills & Payments,Tax payments
18/09/2024,Visa Purchase                 14Sep Standpipe Restaurant Port Augu,103.5,,8690.21,Food & Beverage,Dining out
18/09/2024,Visa Purchase                 14Sep Electrical Discounte Port Augu,99.95,,8793.71,Home & Property,Technology & Appliances
18/09/2024,Visa Purchase                 14Sep Cheap As Chips       Port Augu,35.5,,8893.66,Retail & Personal,Retail (shopping)
18/09/2024,Visa Purchase                 15Sep Harrys Homemade Ff   Port Piri,35.45,,8929.16,Food & Beverage,Food & Groceries
18/09/2024,Visa Purchase                 16Sep Nth Adel Foodland    North Ade,24.2,,8964.61,Food & Beverage,Food & Groceries
18/09/2024,Visa Purchase                 14Sep Standpipe Restaurant Port Augu,24,,8988.81,Food & Beverage,Dining out
18/09/2024,Andrew Kay Manag Wages 15092024,,1366.5,9012.81,Income,Salary
18/09/2024,Eftpos Debit                  18Sep15:12 Costco Kilburn Adelaidkilburn      Sa Au,43.39,,7646.31,Food & Beverage,Food & Groceries
17/09/2024,Visa Purchase                 14Sep Mediterranean Cuisin Port Augu,53.8,,7689.7,Food & Beverage,Dining out
17/09/2024,Visa Purchase                 15Sep Sq *Mamma Lou's      Port Augu,51.4,,7743.5,Food & Beverage,Dining out
17/09/2024,Visa Purchase                 13Sep Sq *Little Nibble Co Port Augu,36.8,,7794.9,Entertainment & Recreation,Catering
17/09/2024,Visa Purchase                 13Sep Smp*Hotel Commonweal Port Augu,20.28,,7831.7,Food & Beverage,Dining out
17/09/2024,Visa Purchase                 13Sep Pastoral Hotel Motel Port Augu,19.5,,7851.98,Transport & Travel,Hotels and Accommodation
17/09/2024,Visa Purchase                 14Sep Gppw Port Augusta    Port Augu,18.98,,7871.48,Retail & Personal,Medical & Personal care
17/09/2024,Visa Purchase                 14Sep Port Augusta French  Port Augu,11,,7890.46,Food & Beverage,Food & Groceries
17/09/2024,Visa Purchase                 14Sep The Reject Shop      Port Augu,8,,7901.46,Retail & Personal,Retail (shopping)
17/09/2024,Visa Purchase                 13Sep Smp*Kiplings Bakery  Port Wake,6.51,,7909.46,Food & Beverage,Food & Groceries
17/09/2024,Visa Purchase                 15Sep Sq *Mamma Lou's      Port Augu,6.5,,7915.97,Food & Beverage,Dining out
16/09/2024,Visa Purchase                 12Sep May Q Korean Restaur Adelaide,77.14,,7922.47,Food & Beverage,Dining out
16/09/2024,Visa Purchase                 13Sep Gn Circleoffriendsa  Summertow,51.63,,7999.61,Bills & Payments,Gifts & Donations
16/09/2024,Visa Purchase                 13Sep Port Augusta French  Port Augu,8,,8051.24,Food & Beverage,Food & Groceries
16/09/2024,Visa Purchase                 13Sep Beam Mobility Austra -,6.61,,8059.24,Bills & Payments,Telecommunications
16/09/2024,Visa Purchase                 13Sep Beam Mobility Austra -,4.59,,8065.85,Bills & Payments,Telecommunications
16/09/2024,Eftpos Debit                  15Sep22:36 Uber   *Eats Help.Uber.Com\,6.05,,8070.44,Food & Beverage,Dining out
16/09/2024,Eftpos Credit                 15Sep18:37 Uber Eats* Eats\,,6.05,8076.49,Deposits,Deposit
16/09/2024,Eftpos Debit                  15Sep18:08 Uber Eats* Eats\,55.51,,8070.44,Food & Beverage,Dining out
14/09/2024,Visa Purchase                 11Sep Bakery On O'Connell  North Ade,13.74,,8125.95,Food & Beverage,Food & Groceries
14/09/2024,Visa Purchase                 12Sep Nth Adel Foodland    North Ade,6,,8139.69,Food & Beverage,Food & Groceries
13/09/2024,Visa Purchase                 11Sep Aware Women's Health North Ade,38.02,,8145.69,Retail & Personal,Medical & Personal care
13/09/2024,Visa Purchase                 11Sep Nth Adel Foodland    North Ade,7.15,,8183.71,Food & Beverage,Food & Groceries
13/09/2024,Eftpos Debit                  13Sep08:37 Bakery On O'Connell   North Adelaidsa Au,12.02,,8190.86,Food & Beverage,Food & Groceries
12/09/2024,Visa Purchase                 09Sep Rising Dream Pty Ltd North Ade,72,,8202.88,Retail & Personal,Medical & Personal care
12/09/2024,Visa Purchase                 10Sep Prestige Dry Clean   North Ade,26.4,,8274.88,Home & Property,Services & Tradespeople
12/09/2024,Eftpos Credit                 12Sep21:43 Uber* Trip\,,0.01,8301.28,Deposits,Deposit
12/09/2024,Eftpos Debit                  12Sep21:33 Uber* Trip\,12.45,,8301.27,Transport & Travel,Taxi & Rental car
12/09/2024,Eftpos Debit                  12Sep18:36 Uber* Trip\,12.76,,8313.72,Transport & Travel,Taxi & Rental car
12/09/2024,Eftpos Debit                  12Sep13:04 Zlr*Haru Sushi        North Adelaidsa Au,10,,8326.48,Food & Beverage,Dining out
11/09/2024,Visa Purchase                 09Sep Nth Adel Foodland    North Ade,41.24,,8336.48,Food & Beverage,Food & Groceries
11/09/2024,Foreign Currency Conversn Fee,0.1,,8377.72,Fees & Charges,Fees & Charges
11/09/2024,Visa Purchase O/Seas          07Sep Sgd2.99 Amznprimesg Membersh,3.45,,8377.82,Entertainment & Recreation,TV
9/09/2024,Visa Purchase                 06Sep Nth Adel Foodland    North Ade,22.4,,8381.27,Food & Beverage,Food & Groceries
9/09/2024,Visa Purchase                 05Sep Brighton & Seacliff  Seacliff,11.8,,8403.67,Food & Beverage,Dining out
9/09/2024,Eftpos Debit                  09Sep09:30 Bakery On O'Connell   North Adelaidsa Au,23.94,,8415.47,Food & Beverage,Food & Groceries
7/09/2024,Visa Purchase                 05Sep Raa                  Mile End,103,,8439.41,Transport & Travel,Vehicle Expenses
7/09/2024,Visa Purchase                 05Sep Brighton & Seacliff  Seacliff,59,,8542.41,Food & Beverage,Dining out
7/09/2024,Visa Purchase                 04Sep Mitolo Coffee        Welland,27.68,,8601.41,Food & Beverage,Beverages
7/09/2024,Visa Purchase                 05Sep Brighton & Seacliff  Seacliff,23.6,,8629.09,Food & Beverage,Dining out
7/09/2024,Visa Purchase                 05Sep Sq *Village Asian Gr North Ade,19.4,,8652.69,Food & Beverage,Food & Groceries
7/09/2024,Visa Purchase                 05Sep Nth Adel Foodland    North Ade,14.73,,8672.09,Food & Beverage,Food & Groceries
7/09/2024,Eftpos Debit                  07Sep10:02 Bakery On O'Connell   North Adelaidsa Au,11.21,,8686.82,Food & Beverage,Food & Groceries
6/09/2024,Visa Purchase                 03Sep Amazon Au            Sydney So,79.8,,8698.03,Retail & Personal,Retail (shopping)
6/09/2024,Visa Purchase                 04Sep Cappos Fish Market   Adelaide,37.75,,8777.83,Food & Beverage,Food & Groceries
6/09/2024,Visa Purchase                 03Sep Telstra Prepaid      Melbourne,35,,8815.58,Bills & Payments,Telecommunications
6/09/2024,Visa Purchase                 03Sep Telstra Prepaid      Melbourne,10,,8850.58,Bills & Payments,Telecommunications
6/09/2024,Visa Purchase                 04Sep Beam Mobility Austra -,8.14,,8860.58,Bills & Payments,Telecommunications
6/09/2024,Visa Purchase                 04Sep Neuronau* Temphold-D Hawthorn,5.59,,8868.72,Transport & Travel,Vehicle Expenses
6/09/2024,Visa Purchase                 04Sep Neuronau* Temphold-C Hawthorn,5.59,,8874.31,Transport & Travel,Vehicle Expenses
6/09/2024,Eftpos Debit                  06Sep21:37 Uber* Trip\,13.95,,8879.9,Transport & Travel,Taxi & Rental car
6/09/2024,Eftpos Debit                  06Sep17:44 Neuronau* Trip-33\,7.12,,8893.85,Transport & Travel,Vehicle Expenses
6/09/2024,Eftpos Debit                  06Sep09:31 Bakery On O'Connell   North Adelaidsa Au,28.79,,8900.97,Food & Beverage,Food & Groceries
5/09/2024,Visa Purchase                 02Sep Bakery On O'Connell  North Ade,29.49,,8929.76,Food & Beverage,Food & Groceries
5/09/2024,Visa Purchase                 03Sep Neuronau* Temphold-Y Hawthorn,5.59,,8959.25,Transport & Travel,Vehicle Expenses
5/09/2024,Tafe Ap 30178466,,20,8964.84,Deposits,Deposit
4/09/2024,Visa Purchase                 02Sep Nth Adel Foodland    North Ade,29,,8944.84,Food & Beverage,Food & Groceries
4/09/2024,Visa Purchase                 01Sep Bakery On O'Connell  North Ade,19.19,,8973.84,Food & Beverage,Food & Groceries
4/09/2024,Visa Purchase                 01Sep Nth Adel Foodland    North Ade,13.32,,8993.03,Food & Beverage,Food & Groceries
4/09/2024,Andrew Kay Manag Wages 01092024,,617,9006.35,Income,Salary
4/09/2024,Eftpos Debit                  04Sep16:27 Jarvis Subaru         Adelaide     Sa Au,1309,,8389.35,Transport & Travel,Vehicle Expenses
3/09/2024,Visa Purchase                 01Sep Patreon* Membership  Internet,36.85,,9698.35,Entertainment & Recreation,TV
3/09/2024,Visa Purchase                 30Aug Bakery On O'Connell  North Ade,12.63,,9735.2,Food & Beverage,Food & Groceries
3/09/2024,Visa Purchase                 31Aug Neuronau* Temphold-M Hawthorn,5.59,,9747.83,Transport & Travel,Vehicle Expenses
3/09/2024,Eftpos Debit                  03Sep13:52 Neuronau* Trip-74\,6.1,,9753.42,Transport & Travel,Vehicle Expenses
2/09/2024,Visa Purchase                 29Aug Costco Wholesale Aus Kilburn,547.85,,9759.52,Food & Beverage,Food & Groceries
2/09/2024,Visa Purchase                 30Aug Sq *Ricky's Chicken  North Ade,38.44,,10307.37,Food & Beverage,Dining out
2/09/2024,Eftpos Debit                  01Sep01:13 Uber   *Trip Help.Uber.Com\,3,,10345.81,Transport & Travel,Taxi & Rental car
31/08/2024,Visa Purchase                 29Aug Brighton & Seacliff  Seacliff,57,,10348.81,Food & Beverage,Dining out
31/08/2024,Visa Purchase                 29Aug Brighton & Seacliff  Seacliff,22.8,,10405.81,Food & Beverage,Dining out
31/08/2024,Visa Purchase                 28Aug Bakery On O'Connell  North Ade,18.69,,10428.61,Food & Beverage,Food & Groceries
31/08/2024,Visa Purchase                 29Aug Brighton & Seacliff  Seacliff,15,,10447.3,Food & Beverage,Dining out
31/08/2024,Eftpos Credit                 31Aug22:10 Uber* Trip\,,0.21,10462.3,Deposits,Deposit
31/08/2024,Eftpos Debit                  31Aug21:54 Uber* Trip\,19.66,,10462.09,Transport & Travel,Taxi & Rental car
31/08/2024,Eftpos Debit                  31Aug17:41 Uber* Trip\,19.8,,10481.75,Transport & Travel,Taxi & Rental car
31/08/2024,Eftpos Debit                  31Aug14:54 Neuronau* Trip-Yp\,7.12,,10501.55,Transport & Travel,Vehicle Expenses
30/08/2024,Visa Purchase                 28Aug Neuronau* Temphold-M Hawthorn,5.08,,10508.67,Transport & Travel,Vehicle Expenses
30/08/2024,Eftpos Debit                  30Aug09:29 Bakery On O'Connell   North Adelaidsa Au,20.1,,10513.75,Food & Beverage,Food & Groceries
30/08/2024,Ato Ato006000020240120,,6337.06,10533.85,Government payments,Tax refunds
29/08/2024,Visa Purchase                 27Aug Cappos Fish Market   Adelaide,28.98,,4196.79,Food & Beverage,Food & Groceries
29/08/2024,Visa Purchase                 27Aug Nth Adel Foodland    North Ade,27.65,,4225.77,Food & Beverage,Food & Groceries
29/08/2024,Visa Purchase                 27Aug Bobo & Associates Pt Adelaide,8.7,,4253.42,Retail & Personal,Retail (shopping)
29/08/2024,Visa Purchase                 27Aug Thompsons Fruit & Ve Adelaide,8.41,,4262.12,Food & Beverage,Food & Groceries
29/08/2024,Eftpos Debit                  29Aug10:48 Costco Kilburn Adelaidkilburn      Sa Au,40.86,,4270.53,Food & Beverage,Food & Groceries
29/08/2024,Tfr Wdl BPAY Internet         29Aug06:02 440057              City Of Adelaide,567,,4311.39,Bills & Payments,Tax payments
28/08/2024,Visa Purchase                 25Aug Bakery On O'Connell  North Ade,25.76,,4878.39,Food & Beverage,Food & Groceries
28/08/2024,Visa Purchase                 26Aug Nth Adel Foodland    North Ade,14.97,,4904.15,Food & Beverage,Food & Groceries
28/08/2024,Eftpos Debit                  28Aug13:16 Neuronau* Trip-Xw\,7.12,,4919.12,Transport & Travel,Vehicle Expenses
27/08/2024,Visa Purchase                 23Aug Bakery On O'Connell  North Ade,12.42,,4926.24,Food & Beverage,Food & Groceries
26/08/2024,Visa Purchase                 22Aug Costco Wholesale Aus Kilburn,193.97,,4938.66,Food & Beverage,Food & Groceries
26/08/2024,Visa Purchase                 22Aug The Cancer Council S Eastwood,30,,5132.63,Bills & Payments,Utilities & Rates
26/08/2024,Visa Purchase                 23Aug Ls Perrymans Bakery  North Ade,14.9,,5162.63,Food & Beverage,Food & Groceries
24/08/2024,Visa Purchase                 21Aug Bakery On O'Connell  North Ade,18.69,,5177.53,Food & Beverage,Food & Groceries
24/08/2024,Visa Purchase                 22Aug Brow Threads & Lashe Salisbury,18.24,,5196.22,Retail & Personal,Retail (shopping)
24/08/2024,Visa Purchase                 22Aug Zlr*Haru Sushi       North Ade,10,,5214.46,Food & Beverage,Dining out
23/08/2024,Visa Purchase                 21Aug Sumar Grocery Pty Lt North Ade,58.48,,5224.46,Food & Beverage,Dining out
23/08/2024,Visa Purchase                 21Aug Nth Adel Foodland    North Ade,4.25,,5282.94,Food & Beverage,Food & Groceries
22/08/2024,Visa Purchase                 20Aug Krung Thep           North Ade,91.91,,5287.19,Food & Beverage,Dining out
22/08/2024,Visa Purchase                 19Aug Amazon Marketplace A Sydney So,28.99,,5379.1,Retail & Personal,Retail (shopping)
22/08/2024,Visa Purchase                 20Aug Nth Adel Foodland    North Ade,22.92,,5408.09,Food & Beverage,Food & Groceries
22/08/2024,Visa Purchase                 20Aug Nth Adel Foodland    North Ade,7.9,,5431.01,Food & Beverage,Food & Groceries
22/08/2024,Eftpos Debit                  22Aug17:15 Zlr*Metropolitan Freshnorth Adelaidsa Au,17.74,,5438.91,Food & Beverage,Food & Groceries
22/08/2024,Eftpos Debit                  22Aug13:52 Neuronau* Trip-Te\,7.12,,5456.65,Transport & Travel,Vehicle Expenses
22/08/2024,Atm Withdrawal                22Aug11:23 Banksa                Adelaide     5  Au,300,,5463.77,Withdrawals & Transfers,ATM & EFTPOS
22/08/2024,Eftpos Debit                  22Aug11:48 Neuronau* Trip-Rc\,6.1,,5763.77,Transport & Travel,Vehicle Expenses
21/08/2024,Visa Purchase                 17Aug Nth Adel Foodland    North Ade,22.48,,5769.87,Food & Beverage,Food & Groceries
21/08/2024,Visa Purchase                 18Aug Nth Adel Foodland    North Ade,16.08,,5792.35,Food & Beverage,Food & Groceries
20/08/2024,Visa Purchase                 18Aug Bakery On O'Connell  North Ade,18.59,,5808.43,Food & Beverage,Food & Groceries
20/08/2024,Visa Purchase                 16Aug Beam Mobility Austra -,7.12,,5827.02,Bills & Payments,Telecommunications
19/08/2024,Visa Purchase                 15Aug Say Cheese           Adelaide,34.92,,5834.14,Food & Beverage,Food & Groceries
19/08/2024,Visa Purchase                 15Aug Bakery On O'Connell  North Ade,22.22,,5869.06,Food & Beverage,Food & Groceries
19/08/2024,Visa Purchase                 16Aug Nth Adel Foodland    North Ade,20,,5891.28,Food & Beverage,Food & Groceries
19/08/2024,Visa Purchase                 15Aug Cons Fine Food       Adelaide,18.37,,5911.28,Food & Beverage,Food & Groceries
19/08/2024,Visa Purchase                 15Aug House Of Health Coll Adelaide,15.8,,5929.65,Food & Beverage,Food & Groceries
19/08/2024,Visa Purchase                 15Aug Hong Kong Grocery St Adelaide,14.17,,5945.45,Food & Beverage,Food & Groceries
19/08/2024,Eftpos Debit                  19Aug09:30 Bakery On O'Connell   North Adelaidsa Au,12.12,,5959.62,Food & Beverage,Food & Groceries
19/08/2024,Eftpos Credit                 18Aug00:54 Uber* Trip\,,0.02,5971.74,Deposits,Deposit
19/08/2024,Eftpos Debit                  18Aug00:41 Uber* Trip\,20.06,,5971.72,Transport & Travel,Taxi & Rental car
19/08/2024,Eftpos Debit                  17Aug21:10 Uber* Trip\,20.3,,5991.78,Transport & Travel,Taxi & Rental car
17/08/2024,Visa Purchase                 14Aug Color Club Pty Ltd   North Ade,72.72,,6012.08,Retail & Personal,Retail (shopping)
17/08/2024,Visa Purchase                 15Aug Zlr*Cocos@Centralmar Adelaide,15.85,,6084.8,Food & Beverage,Food & Groceries
17/08/2024,Visa Purchase                 15Aug Bobo & Associates Pt Adelaide,8,,6100.65,Retail & Personal,Retail (shopping)
17/08/2024,Atm Withdrawal                17Aug14:58 Atmx 139 Oconnell St   North Adelaid08Au,150,,6108.65,Withdrawals & Transfers,ATM & EFTPOS
17/08/2024,Eftpos Debit                  17Aug10:05 Bakery On O'Connell   North Adelaidsa Au,23.43,,6258.65,Food & Beverage,Food & Groceries
16/08/2024,Eftpos Debit                  16Aug09:28 Bakery On O'Connell   North Adelaidsa Au,24.24,,6282.08,Food & Beverage,Food & Groceries
15/08/2024,Visa Purchase                 12Aug Ticketek Web         Sydney,757.45,,6306.32,Entertainment & Recreation,Attractions
15/08/2024,Visa Purchase                 13Aug Gn Circleoffriendsa  Summertow,51.63,,7063.77,Bills & Payments,Gifts & Donations
15/08/2024,Visa Purchase                 13Aug Prestige Dry Clean   North Ade,33,,7115.4,Home & Property,Services & Tradespeople
15/08/2024,Visa Purchase                 13Aug Nth Adel Foodland    North Ade,16.94,,7148.4,Food & Beverage,Food & Groceries
15/08/2024,Eftpos Debit                  15Aug16:24 Neuronau* Trip-Lb\,6.61,,7165.34,Transport & Travel,Vehicle Expenses
15/08/2024,Eftpos Debit                  15Aug14:58 Neuronau* Trip-Hk\,6.61,,7171.95,Transport & Travel,Vehicle Expenses
14/08/2024,Visa Purchase                 12Aug Grill'd (Norwood)    Norwood,19.1,,7178.56,Food & Beverage,Dining out
14/08/2024,Visa Purchase                 11Aug Nth Adel Foodland    North Ade,14,,7197.66,Food & Beverage,Food & Groceries
14/08/2024,Visa Purchase                 12Aug Nth Adel Foodland    North Ade,10.99,,7211.66,Food & Beverage,Food & Groceries
14/08/2024,Visa Purchase                 11Aug North Adelaide Haru  North Ade,10,,7222.65,Food & Beverage,Dining out
14/08/2024,Tfr Wdl BPAY Internet         14Aug11:46 0207782150          Sa Water,175.01,,7232.65,Bills & Payments,Utilities & Rates
14/08/2024,Eftpos Debit                  14Aug10:30 Bakery On O'Connell   North Adelaidsa Au,17.78,,7407.66,Food & Beverage,Food & Groceries
13/08/2024,Foreign Currency Conversn Fee,0.1,,7425.44,Fees & Charges,Fees & Charges
13/08/2024,Visa Purchase O/Seas          07Aug Sgd2.99 Amznprimesg Membersh,3.48,,7425.54,Entertainment & Recreation,TV
13/08/2024,Eftpos Debit                  13Aug18:51 Neuronau* Trip-Y1\,7.63,,7429.02,Transport & Travel,Vehicle Expenses
13/08/2024,Osko Withdrawal               13Aug16:19 Betta Home Furnishings,267.5,,7436.65,Withdrawals & Transfers,Withdrawal
12/08/2024,Osko Withdrawal               12Aug18:38 Solid Pink Disco Jodi Godby,135,,7704.15,Withdrawals & Transfers,Withdrawal
12/08/2024,Eftpos Debit                  12Aug14:41 Www.Gelatomessina.Com\,32,,7839.15,Food & Beverage,Dining out
10/08/2024,Visa Purchase                 06Aug Adelaide Entertainme Hindmarsh,45.4,,7871.15,Food & Beverage,Dining out
10/08/2024,Visa Purchase                 07Aug Telstra Prepaid      Melbourne,35,,7916.55,Bills & Payments,Telecommunications
10/08/2024,Visa Purchase                 07Aug Bakery On O'Connell  North Ade,12.12,,7951.55,Food & Beverage,Food & Groceries
10/08/2024,Visa Purchase                 07Aug Telstra Prepaid      Melbourne,10,,7963.67,Bills & Payments,Telecommunications
10/08/2024,Visa Purchase                 08Aug Bounce - Usebounce.C Httpsuseb,4.1,,7973.67,Home & Property,Services & Tradespeople
10/08/2024,Eftpos Debit                  10Aug15:30 Uber* Trip\,14.8,,7977.77,Transport & Travel,Taxi & Rental car
10/08/2024,Eftpos Debit                  10Aug13:13 Uber* Trip\,14.97,,7992.57,Transport & Travel,Taxi & Rental car
9/08/2024,Eftpos Debit                  09Aug19:08 Uber* Trip\,30.72,,8007.54,Transport & Travel,Taxi & Rental car
9/08/2024,Eftpos Debit                  09Aug13:24 Www.Gelatomessina.Com\,27.6,,8038.26,Food & Beverage,Food & Groceries
8/08/2024,Visa Purchase                 06Aug Elysian Salon & Spa  Adelaide,504.3,,8065.86,Retail & Personal,Retail (shopping)
8/08/2024,Visa Purchase                 06Aug Zlr*Mr Viet - Chinat Adelaide,18.17,,8570.16,Food & Beverage,Dining out
8/08/2024,Visa Purchase                 06Aug Beam Mobility Austra -,7.63,,8588.33,Bills & Payments,Telecommunications
8/08/2024,Eftpos Debit                  08Aug11:28 Uber* Trip\,5,,8595.96,Transport & Travel,Taxi & Rental car
7/08/2024,Visa Purchase                 04Aug Nth Adel Foodland    North Ade,16.75,,8600.96,Food & Beverage,Food & Groceries
7/08/2024,Visa Purchase                 05Aug Zlr*St George's Bake Adelaide,12,,8617.71,Food & Beverage,Food & Groceries
7/08/2024,Visa Purchase                 05Aug Zlr*St George's Bake Adelaide,5.5,,8629.71,Food & Beverage,Food & Groceries
7/08/2024,Andrew Kay Manag Wages 04082024,,556,8635.21,Income,Salary
7/08/2024,Eftpos Debit                  07Aug13:45 Uber* Trip\,34.26,,8079.21,Transport & Travel,Taxi & Rental car
6/08/2024,Visa Purchase                 01Aug Ampol North Adelaide North Ade,55.99,,8113.47,Transport & Travel,Petrol
6/08/2024,Visa Purchase                 04Aug Bws/123 Oconnell Str Nrth Adel,51,,8169.46,Food & Beverage,Beverages
6/08/2024,Visa Purchase                 01Aug Bettys Burgers Austr Adelaide,30.9,,8220.46,Food & Beverage,Dining out
6/08/2024,Visa Purchase                 03Aug Coles 4940           Mount Bar,27.3,,8251.36,Food & Beverage,Food & Groceries
6/08/2024,Visa Purchase                 04Aug Zlr*Metropolitan Fre North Ade,22.27,,8278.66,Food & Beverage,Food & Groceries
6/08/2024,Visa Purchase                 03Aug Lowe's Meat Co.      Mount Bar,20.67,,8300.93,Food & Beverage,Food & Groceries
6/08/2024,Visa Purchase                 03Aug Kmart 1167           Mount Bar,16,,8321.6,Retail & Personal,Retail (shopping)
6/08/2024,Osko Withdrawal               06Aug14:47 Jvl Painters Pty Ltd,4895,,8337.6,Withdrawals & Transfers,Withdrawal
6/08/2024,Eftpos Debit                  06Aug13:34 Neuronau* Trip-Kw\,8.14,,13232.6,Transport & Travel,Vehicle Expenses
5/08/2024,Visa Purchase                 01Aug Post North Adelaide  North Ade,31.85,,13240.74,Bills & Payments,Professional & Govt services
5/08/2024,Visa Purchase                 02Aug Nth Adel Foodland    North Ade,6.5,,13272.59,Food & Beverage,Food & Groceries
5/08/2024,Visa Purchase                 01Aug North Adelaide News  North Ade,6,,13279.09,Entertainment & Recreation,Books & Subscriptions
5/08/2024,Visa Purchase                 01Aug Beam Mobility Austra -,4.06,,13285.09,Bills & Payments,Telecommunications
5/08/2024,Eftpos Debit                  04Aug09:25 Bakery On O'Connell   North Adelaidsa Au,18.48,,13289.15,Food & Beverage,Food & Groceries
3/08/2024,Visa Purchase                 01Aug Patreon* Membership  Internet,36.85,,13307.63,Entertainment & Recreation,TV
3/08/2024,Visa Purchase                 01Aug Alh Venues/123 Oconn Nrth Adel,26.4,,13344.48,Transport & Travel,Hotels and Accommodation
3/08/2024,Visa Purchase                 31Jul Color Club Pty Ltd   North Ade,25.25,,13370.88,Retail & Personal,Retail (shopping)
3/08/2024,Visa Purchase                 01Aug Alh Venues/123 Oconn Nrth Adel,10.8,,13396.13,Transport & Travel,Hotels and Accommodation
3/08/2024,Eftpos Debit                  03Aug19:22 Bakery On O'Connell   North Adelaidsa Au,9.09,,13406.93,Food & Beverage,Food & Groceries
3/08/2024,Eftpos Debit                  03Aug19:19 Indii Flavours Pty \North Adelaide    Au,99.69,,13416.02,Food & Beverage,Dining out
2/08/2024,Visa Purchase                 30Jul Wellington Hotel     North Ade,83,,13515.71,Food & Beverage,Beverages
2/08/2024,Visa Purchase                 30Jul Wellington Hotel     North Ade,20.5,,13598.71,Food & Beverage,Beverages
2/08/2024,Visa Purchase                 30Jul Bakery On O'Connell  North Ade,18.99,,13619.21,Food & Beverage,Food & Groceries
2/08/2024,Visa Purchase                 30Jul Amazon Marketplace A Sydney So,15.98,,13638.2,Retail & Personal,Retail (shopping)
2/08/2024,Visa Purchase                 31Jul Zlr*Haru Sushi       North Ade,10,,13654.18,Food & Beverage,Dining out
1/08/2024,Visa Purchase                 29Jul Costco Wholesale Aus Kilburn,212.92,,13664.18,Food & Beverage,Food & Groceries
1/08/2024,Visa Purchase                 29Jul Amazon Marketplace A Sydney So,51.25,,13877.1,Retail & Personal,Retail (shopping)
1/08/2024,Visa Purchase                 29Jul Momoshi Pty Ltd      Kilburn,22.74,,13928.35,Food & Beverage,Dining out
1/08/2024,Visa Purchase                 29Jul Bakery On O'Connell  North Ade,22.22,,13951.09,Food & Beverage,Food & Groceries
1/08/2024,Visa Purchase                 30Jul Nth Adel Foodland    North Ade,15.52,,13973.31,Food & Beverage,Food & Groceries
1/08/2024,Atm Withdrawal                01Aug17:35 Banksa                Adelaide     5  Au,300,,13988.83,Withdrawals & Transfers,ATM & EFTPOS
1/08/2024,Eftpos Debit                  01Aug16:19 Ozt*The Angels - 50 No\,200,,14288.83,Entertainment & Recreation,Sports & Leisure
31/07/2024,Visa Purchase                 29Jul Krung Thep           North Ade,97.42,,14488.83,Food & Beverage,Dining out
31/07/2024,Visa Purchase                 29Jul Kmart 1223           Kilburn,29,,14586.25,Retail & Personal,Retail (shopping)
31/07/2024,Visa Purchase                 29Jul Nth Adel Foodland    North Ade,24.29,,14615.25,Food & Beverage,Food & Groceries
31/07/2024,Visa Purchase                 28Jul Nth Adel Foodland    North Ade,18.98,,14639.54,Food & Beverage,Food & Groceries
31/07/2024,Visa Purchase                 27Jul Nth Adel Foodland    North Ade,12.35,,14658.52,Food & Beverage,Food & Groceries
31/07/2024,Osko Withdrawal               31Jul17:24 2Nd Fix Hardware Pty Ltd,11857.44,,14670.87,Withdrawals & Transfers,Withdrawal
31/07/2024,Internet Deposit              31Jul13:35 From 0280074494440,,20000,26528.31,Deposits,Deposit
30/07/2024,Visa Purchase                 27Jul The Coffee Bean Shop Welland,27.74,,6528.31,Food & Beverage,Beverages
30/07/2024,Visa Purchase                 26Jul Crown And Anchor Hot Adelaide,18.22,,6556.05,Food & Beverage,Dining out
30/07/2024,Visa Purchase                 27Jul Thompsons Fruit & Ve Adelaide,11.61,,6574.27,Food & Beverage,Food & Groceries
30/07/2024,Visa Purchase                 26Jul Crown And Anchor Hot Adelaide,9.11,,6585.88,Food & Beverage,Dining out
30/07/2024,Visa Purchase                 27Jul House Of Health Coll Adelaide,8.8,,6594.99,Food & Beverage,Food & Groceries
30/07/2024,Visa Purchase                 27Jul Bobo & Associates Pt Adelaide,8,,6603.79,Retail & Personal,Retail (shopping)
30/07/2024,Visa Purchase                 25Jul Airport Retail Enter Melbourne,6.98,,6611.79,Food & Beverage,Dining out
30/07/2024,Visa Purchase                 27Jul Neuronau* Temphold-K Hawthorn,5.59,,6618.77,Transport & Travel,Vehicle Expenses
29/07/2024,Visa Purchase                 26Jul Nth Adel Foodland    North Ade,76.82,,6624.36,Food & Beverage,Food & Groceries
29/07/2024,Visa Purchase                 26Jul Sq *Glam Medical Spa North Ade,45,,6701.18,Retail & Personal,Retail (shopping)
29/07/2024,Atm Withdrawal                29Jul15:28 Atmx 139 Oconnell St   North Adelaid08Au,500,,6746.18,Withdrawals & Transfers,ATM & EFTPOS
29/07/2024,Eftpos Debit                  29Jul11:57 Costco Kilburn Adelaidkilburn      Sa Au,63,,7246.18,Food & Beverage,Food & Groceries
29/07/2024,Eftpos Debit                  28Jul16:35 Kx Pilates Nth Adelaide\,310,,7309.18,Retail & Personal,Health & Fitness
27/07/2024,Visa Purchase                 25Jul Zlr*The Grace-Melbou Melbourne,43.6,,7619.18,Food & Beverage,Food & Groceries
26/07/2024,Foreign Currency Conversn Fee,1.27,,7662.78,Fees & Charges,Fees & Charges
26/07/2024,Visa Purchase O/Seas          24Jul Hkd219.00 Duty Zero By Cdf,42.46,,7664.05,Retail & Personal,Retail (shopping)
26/07/2024,Eftpos Debit                  26Jul17:15 Neuronau* Trip-95\,6.61,,7706.51,Transport & Travel,Vehicle Expenses
26/07/2024,Osko Withdrawal               26Jul12:29 The Garage Door Guys,2095,,7713.12,Withdrawals & Transfers,Withdrawal
26/07/2024,Eftpos Debit                  26Jul08:23 Bakery On O'Connell   North Adelaidsa Au,6.16,,9808.12,Food & Beverage,Food & Groceries
24/07/2024,Foreign Currency Conversn Fee,0.48,,9814.28,Fees & Charges,Fees & Charges
24/07/2024,Visa Purchase O/Seas          21Jul Usd10.75 Mta*Lirr Station Tix,16.1,,9814.76,Transport & Travel,Public transport
19/07/2024,Foreign Currency Conversn Fee,1.48,,9830.86,Fees & Charges,Fees & Charges
19/07/2024,Visa Purchase O/Seas          17Jul Usd33.20 Barney Greengrass,49.46,,9832.34,Food & Beverage,Dining out
19/07/2024,Visa Purchase                 16Jul Telstra Prepaid      Melbourne,35,,9881.8,Bills & Payments,Telecommunications
19/07/2024,Foreign Currency Conversn Fee,0.74,,9916.8,Fees & Charges,Fees & Charges
19/07/2024,Visa Purchase O/Seas          17Jul Usd16.86 Tst* Just Salad - Ue,24.98,,9917.54,Food & Beverage,Dining out
17/07/2024,Visa Purchase                 14Jul Telstra Prepaid      Melbourne,25,,9942.52,Bills & Payments,Telecommunications
16/07/2024,Visa Purchase                 13Jul Gn Circleoffriendsa  Summertow,51.63,,9967.52,Bills & Payments,Gifts & Donations
16/07/2024,Foreign Currency Conversn Fee,0.12,,10019.15,Fees & Charges,Fees & Charges
16/07/2024,Visa Purchase O/Seas          13Jul Usd2.90 Mta*Nyct Paygo,4.3,,10019.27,Transport & Travel,Public transport
11/07/2024,Foreign Currency Conversn Fee,0.09,,10023.57,Fees & Charges,Fees & Charges
11/07/2024,Visa Purchase O/Seas          07Jul Sgd2.99 Amznprimesg Membersh,3.3,,10023.66,Entertainment & Recreation,TV
11/07/2024,Internet Deposit              11Jul09:08 From 0280074494440,,3000,10026.96,Deposits,Deposit
10/07/2024,Andrew Kay Manag Wages 07072024,,309.5,7026.96,Income,Salary
5/07/2024,Visa Purchase                 02Jul Telstra Prepaid      Melbourne,25,,6717.46,Bills & Payments,Telecommunications
3/07/2024,Visa Purchase                 01Jul Patreon* Membership  Internet,36.85,,6742.46,Entertainment & Recreation,TV
27/06/2024,Internet Deposit              27Jun06:01 From 0280074494440,,802.35,6779.31,Deposits,Deposit
26/06/2024,Deft Payments Deft      23419941,942.99,,5976.96,Bills & Payments,Expenses & Payments
24/06/2024,Visa Purchase                 20Jun Telstra Prepaid      Melbourne,25,,6919.95,Bills & Payments,Telecommunications
24/06/2024,Visa Purchase                 20Jun Out Of Australia     Melbourne,10.09,,6944.95,Retail & Personal,Retail (shopping)
22/06/2024,Visa Purchase                 19Jun Color Club Pty Ltd   North Ade,25.25,,6955.04,Retail & Personal,Retail (shopping)
21/06/2024,Visa Purchase                 18Jun Sue & Jay Trust      Adelaide,19.9,,6980.29,Food & Beverage,Dining out
21/06/2024,Visa Purchase                 18Jun Bakery On O'Connell  North Ade,19.7,,7000.19,Food & Beverage,Food & Groceries
21/06/2024,Visa Purchase                 19Jun Alh Venues/123 Oconn Nrth Adel,17,,7019.89,Transport & Travel,Hotels and Accommodation
21/06/2024,Visa Purchase                 19Jun Alh Venues/123 Oconn Nrth Adel,17,,7036.89,Transport & Travel,Hotels and Accommodation
21/06/2024,Visa Purchase                 18Jun Beam Mobility Austra -,4.61,,7053.89,Bills & Payments,Telecommunications
20/06/2024,Visa Purchase                 17Jun Costco Wholesale Aus Kilburn,172.91,,7058.5,Food & Beverage,Food & Groceries
20/06/2024,Visa Purchase                 18Jun Woolworths/80-88 Run Rundle Ma,22.9,,7231.41,Food & Beverage,Food & Groceries
20/06/2024,Visa Purchase                 16Jun Deep Blue Cafe P/L   Moana,14,,7254.31,Food & Beverage,Dining out
20/06/2024,Visa Purchase                 18Jun Mr Viet              Adelaide,7,,7268.31,Food & Beverage,Dining out
20/06/2024,Visa Purchase                 18Jun Skala Bakery         Adelaide,5.97,,7275.31,Food & Beverage,Food & Groceries
20/06/2024,Visa Purchase                 17Jun Tafe Sa Regency Scho Adelaide,5.7,,7281.28,Retail & Personal,Education & Training
20/06/2024,Eftpos Debit                  20Jun19:30 Uber* Trip\,27.3,,7286.98,Transport & Travel,Taxi & Rental car
20/06/2024,Internet Deposit              20Jun06:03 From 0280074494440,,802.35,7314.28,Deposits,Deposit
19/06/2024,Visa Purchase                 17Jun Sq *Earworx Adelaide Adelaide,75,,6511.93,Retail & Personal,Medical & Personal care
18/06/2024,Visa Purchase                 15Jun May Q                Adelaide,83.23,,6586.93,Food & Beverage,Dining out
18/06/2024,Visa Purchase                 15Jun May Q                Adelaide,44.66,,6670.16,Food & Beverage,Dining out
18/06/2024,Visa Purchase                 15Jun Memphis Slims House  Adelaide,38.63,,6714.82,Food & Beverage,Beverages
18/06/2024,Visa Purchase                 14Jun Crown And Anchor Hot Adelaide,26.82,,6753.45,Food & Beverage,Dining out
18/06/2024,Visa Purchase                 15Jun Woodside Foodland    Woodside,23.35,,6780.27,Food & Beverage,Food & Groceries
18/06/2024,Visa Purchase                 15Jun Bakery On O'Connell  North Ade,22.32,,6803.62,Food & Beverage,Food & Groceries
18/06/2024,Visa Purchase                 14Jun Crown And Anchor Hot Adelaide,12.65,,6825.94,Food & Beverage,Dining out
18/06/2024,Visa Purchase                 15Jun Zlr*Onkaparinga Rota Lobethal,6.5,,6838.59,Bills & Payments,Memberships
18/06/2024,Visa Purchase                 15Jun Sq *Rosalie's Market Woodside,6.11,,6845.09,Entertainment & Recreation,Sports & Leisure
18/06/2024,Visa Purchase                 16Jun Eg Group/131-145 Gri Seaford,4,,6851.2,Transport & Travel,Petrol
18/06/2024,Eftpos Debit                  18Jun18:45 Neuronau* Trip-J8\,8.14,,6855.2,Transport & Travel,Vehicle Expenses
18/06/2024,Eftpos Debit                  18Jun17:49 Endota Spa            Adelaide        Au,165,,6863.34,Retail & Personal,Medical & Personal care
18/06/2024,Eftpos Debit                  18Jun07:07 Uber Eats* Eats\,3.13,,7028.34,Food & Beverage,Dining out
17/06/2024,Foreign Currency Conversn Fee,6.32,,7031.47,Fees & Charges,Fees & Charges
17/06/2024,Visa Purchase O/Seas          14Jun Usd139.00 Amazon Prime*Lc74Y7C,210.93,,7037.79,Retail & Personal,Retail (shopping)
17/06/2024,Visa Purchase                 14Jun Krung Thep           North Ade,113.12,,7248.72,Food & Beverage,Dining out
17/06/2024,Visa Purchase                 13Jun Smp*Cafe  Fellini    North Ade,99.92,,7361.84,Food & Beverage,Dining out
17/06/2024,Visa Purchase                 14Jun Prestige Dry Clean   North Ade,78.9,,7461.76,Home & Property,Services & Tradespeople
17/06/2024,Visa Purchase                 14Jun Nth Adel Foodland    North Ade,20.5,,7540.66,Food & Beverage,Food & Groceries
17/06/2024,Eftpos Credit                 17Jun19:08 Uber Eats* Eats\,,3.13,7561.16,Deposits,Deposit
17/06/2024,Eftpos Debit                  17Jun18:44 Uber Eats* Eats\,65.71,,7558.03,Food & Beverage,Dining out
17/06/2024,Eftpos Debit                  16Jun07:49 Uber* Trip\,12.85,,7623.74,Transport & Travel,Taxi & Rental car
17/06/2024,Eftpos Debit                  16Jun05:50 Uber* Trip\,13.98,,7636.59,Transport & Travel,Taxi & Rental car
15/06/2024,Visa Purchase                 13Jun Gn Circleoffriendsa  Summertow,51.63,,7650.57,Bills & Payments,Gifts & Donations
15/06/2024,Visa Purchase                 11Jun Bakery On O'Connell  North Ade,26.46,,7702.2,Food & Beverage,Food & Groceries
15/06/2024,Visa Purchase                 12Jun Beam Mobility Austra -,6.61,,7728.66,Bills & Payments,Telecommunications
15/06/2024,Eftpos Debit                  15Jun16:24 Neuronau* Trip-Bj\,6.1,,7735.27,Transport & Travel,Vehicle Expenses
15/06/2024,Eftpos Debit                  15Jun11:05 Uber* Trip\,14.11,,7741.37,Transport & Travel,Taxi & Rental car
15/06/2024,Eftpos Debit                  15Jun08:32 Uber* Trip\,14.42,,7755.48,Transport & Travel,Taxi & Rental car
14/06/2024,Visa Purchase                 12Jun Elysian Salon & Spa  Adelaide,393.35,,7769.9,Retail & Personal,Retail (shopping)
14/06/2024,Visa Purchase                 12Jun Alh Venues/123 Oconn Nrth Adel,30,,8163.25,Transport & Travel,Hotels and Accommodation
14/06/2024,Visa Purchase                 12Jun Woolworths/80-88 Run Rundle Ma,25.4,,8193.25,Food & Beverage,Food & Groceries
14/06/2024,Visa Purchase                 12Jun Brow Threads & Lashe Salisbury,20.26,,8218.65,Retail & Personal,Retail (shopping)
14/06/2024,Visa Purchase                 12Jun Neuronau* Temphold-G Hawthorn,5.59,,8238.91,Transport & Travel,Vehicle Expenses
14/06/2024,Eftpos Debit                  14Jun09:22 Bakery On O'Connell   North Adelaidsa Au,28.89,,8244.5,Food & Beverage,Food & Groceries
13/06/2024,Visa Purchase                 11Jun Ls Perrymans Bakery  North Ade,10.4,,8273.39,Food & Beverage,Food & Groceries
13/06/2024,Visa Purchase                 11Jun Sq *Tynte Street Qua North Ade,6.53,,8283.79,Food & Beverage,Food & Groceries
13/06/2024,Eftpos Debit                  13Jun20:19 Bakery On O'Connell   North Adelaidsa Au,11.41,,8290.32,Food & Beverage,Food & Groceries
13/06/2024,Eftpos Debit                  13Jun11:50 Airconditioning Repairparadise     Sa Au,232,,8301.73,Home & Property,Services & Tradespeople
13/06/2024,Internet Deposit              13Jun06:00 From 0280074494440,,802.35,8533.73,Deposits,Deposit
12/06/2024,Visa Purchase                 10Jun Google Fitbit Llc    Pyrmont,47.98,,7731.38,Entertainment & Recreation,TV
12/06/2024,Foreign Currency Conversn Fee,0.1,,7779.36,Fees & Charges,Fees & Charges
12/06/2024,Visa Purchase O/Seas          07Jun Sgd2.99 Amznprimesg Membersh,3.34,,7779.46,Entertainment & Recreation,TV
12/06/2024,Atm Withdrawal                12Jun16:06 Banksa                Adelaide     5  Au,300,,7782.8,Withdrawals & Transfers,ATM & EFTPOS
11/06/2024,Visa Credit                   08Jun Beam Mobility Austra -,,2.02,8082.8,Deposits,Deposit
11/06/2024,Visa Purchase                 08Jun Yakitori Takumi      North Ade,261.63,,8080.78,Food & Beverage,Dining out
11/06/2024,Visa Purchase                 07Jun Color Club Pty Ltd   North Ade,25.25,,8342.41,Retail & Personal,Retail (shopping)
11/06/2024,Visa Purchase                 07Jun Bakery On O'Connell  North Ade,16.16,,8367.66,Food & Beverage,Food & Groceries
11/06/2024,Visa Purchase                 08Jun Guzman Y Gomez       Adelaide,14.7,,8383.82,Food & Beverage,Dining out
11/06/2024,Visa Purchase                 08Jun Ls Perrymans Bakery  North Ade,12.4,,8398.52,Food & Beverage,Food & Groceries
11/06/2024,Visa Purchase                 09Jun Prospect Lions Club  Hampstead,5.5,,8410.92,Bills & Payments,Memberships
11/06/2024,Visa Purchase                 08Jun Neuronau* Temphold-1 Hawthorn,4.06,,8416.42,Transport & Travel,Vehicle Expenses
11/06/2024,Visa Purchase                 09Jun Prospect Lions Club  Hampstead,3.5,,8420.48,Bills & Payments,Memberships
11/06/2024,Visa Purchase                 08Jun Beam Mobility Austra -,2.02,,8423.98,Bills & Payments,Telecommunications
10/06/2024,Visa Purchase                 07Jun Ban Ban Rundle Pty L Adelaide,20.91,,8426,Food & Beverage,Dining out
10/06/2024,Visa Purchase                 07Jun Woolworths/80-88 Run Rundle Ma,10,,8446.91,Food & Beverage,Food & Groceries
10/06/2024,Visa Purchase                 06Jun Bakery On O'Connell  North Ade,9.9,,8456.91,Food & Beverage,Food & Groceries
10/06/2024,Visa Purchase                 07Jun Beam Mobility Austra -,8.08,,8466.81,Bills & Payments,Telecommunications
10/06/2024,Visa Purchase                 07Jun Beam Mobility Austra -,6.31,,8474.89,Bills & Payments,Telecommunications
10/06/2024,Eftpos Debit                  10Jun14:50 Neuronau* Trip-Vd\,6.85,,8481.2,Transport & Travel,Vehicle Expenses
10/06/2024,Eftpos Debit                  09Jun05:45 Uber* Trip\,12.26,,8488.05,Transport & Travel,Taxi & Rental car
8/06/2024,Visa Purchase                 05Jun Telstra Prepaid      Melbourne,35,,8500.31,Bills & Payments,Telecommunications
8/06/2024,Visa Purchase                 06Jun Sushi Hiro Au        North Ade,26.77,,8535.31,Food & Beverage,Dining out
8/06/2024,Visa Purchase                 05Jun Bakery On O'Connell  North Ade,26.46,,8562.08,Food & Beverage,Food & Groceries
8/06/2024,Visa Purchase                 05Jun Wellington Hotel     North Ade,25,,8588.54,Food & Beverage,Beverages
8/06/2024,Eftpos Debit                  08Jun16:27 Neuronau* Trip-Xg\,6.61,,8613.54,Transport & Travel,Vehicle Expenses
8/06/2024,Eftpos Debit                  08Jun09:03 Uber* Trip\,12.29,,8620.15,Transport & Travel,Taxi & Rental car
8/06/2024,Eftpos Debit                  08Jun06:47 Uber* Trip\,12.66,,8632.44,Transport & Travel,Taxi & Rental car
7/06/2024,Visa Purchase                 05Jun Smgb Mount Barker    Mount Bar,64.99,,8645.1,Bills & Payments,Gifts & Donations
7/06/2024,Visa Purchase                 05Jun Coles 4940           Mount Bar,6,,8710.09,Food & Beverage,Food & Groceries
7/06/2024,Eftpos Debit                  07Jun07:16 Uber Eats* Eats\,5.86,,8716.09,Food & Beverage,Dining out
6/06/2024,Visa Purchase                 04Jun Gt & Hg Pty Ltd      North Ade,12.27,,8721.95,Food & Beverage,Food & Groceries
6/06/2024,Eftpos Credit                 06Jun19:17 Uber Eats* Eats\,,5.86,8734.22,Deposits,Deposit
6/06/2024,Eftpos Debit                  06Jun18:45 Uber Eats* Eats\,64.43,,8728.36,Food & Beverage,Dining out
6/06/2024,Internet Deposit              06Jun06:04 From 0280074494440,,802.35,8792.79,Deposits,Deposit
5/06/2024,Visa Purchase                 03Jun Sq *The Village Bake Glenside,20.1,,7990.44,Food & Beverage,Food & Groceries
5/06/2024,Visa Purchase                 02Jun Bakery On O'Connell  North Ade,17.17,,8010.54,Food & Beverage,Food & Groceries
5/06/2024,Visa Purchase                 03Jun Gt & Hg Pty Ltd      North Ade,8.34,,8027.71,Food & Beverage,Food & Groceries
5/06/2024,Visa Purchase                 03Jun Sq *Bean2Heaven      Craigmore,6,,8036.05,Food & Beverage,Dining out
4/06/2024,Visa Purchase                 01Jun Niku House           Adelaide,379.2,,8042.05,Food & Beverage,Dining out
4/06/2024,Visa Purchase                 01Jun Patreon* Membership  Internet,36.85,,8421.25,Entertainment & Recreation,TV
4/06/2024,Visa Purchase                 02Jun Neuronau* Trip-Hf    Hawthorn,6.11,,8458.1,Transport & Travel,Vehicle Expenses
4/06/2024,Visa Purchase                 02Jun Neuronau* Temphold-A Hawthorn,5.59,,8464.21,Transport & Travel,Vehicle Expenses
3/06/2024,Visa Purchase                 29May Adelaide Entertainme Hindmarsh,19.4,,8469.8,Food & Beverage,Dining out
3/06/2024,Visa Purchase                 31May V/Cellars 3327       N Adelaid,15,,8489.2,Food & Beverage,Beverages
3/06/2024,Eftpos Debit                  03Jun15:36 Www.Gelatomessina.Com\,34,,8504.2,Food & Beverage,Dining out
3/06/2024,Eftpos Debit                  02Jun11:40 Uber* Trip\,17.16,,8538.2,Transport & Travel,Taxi & Rental car
3/06/2024,Eftpos Debit                  02Jun05:28 Uber* Trip\,15.66,,8555.36,Transport & Travel,Taxi & Rental car
1/06/2024,Visa Purchase                 30May Brighton & Seacliff  Seacliff,76,,8571.02,Food & Beverage,Dining out
1/06/2024,Visa Purchase                 29May Governor Hindmarsh H Hindmarsh,23.4,,8647.02,Food & Beverage,Beverages
1/06/2024,Visa Purchase                 29May Governor Hindmarsh H Hindmarsh,22,,8670.42,Food & Beverage,Beverages
1/06/2024,Visa Purchase                 30May Brighton & Seacliff  Seacliff,19.5,,8692.42,Food & Beverage,Dining out
1/06/2024,Visa Purchase                 30May Brighton & Seacliff  Seacliff,19.5,,8711.92,Food & Beverage,Dining out
1/06/2024,Visa Purchase                 30May Nth Adel Foodland    North Ade,13.49,,8731.42,Food & Beverage,Food & Groceries
1/06/2024,Visa Purchase                 29May Governor Hindmarsh H Hindmarsh,11.2,,8744.91,Food & Beverage,Beverages
1/06/2024,Visa Purchase                 29May Iga Local Grocer - B Bowden,2.75,,8756.11,Food & Beverage,Food & Groceries
1/06/2024,Eftpos Debit                  01Jun11:31 Bakery On O'Connell   North Adelaidsa Au,11.11,,8758.86,Food & Beverage,Food & Groceries
1/06/2024,Eftpos Debit                  01Jun07:45 Uber* Trip\,12.17,,8769.97,Transport & Travel,Taxi & Rental car
1/06/2024,Eftpos Debit                  01Jun05:39 Uber* Trip\,11.97,,8782.14,Transport & Travel,Taxi & Rental car
31/05/2024,Visa Purchase                 29May Smgb Mount Barker    Mount Bar,64.99,,8794.11,Bills & Payments,Gifts & Donations
31/05/2024,Visa Purchase                 29May Lobethal Bakery      Lobethal,30.4,,8859.1,Food & Beverage,Food & Groceries
31/05/2024,Visa Purchase                 28May Tafe Sa Regency Scho Adelaide,5.7,,8889.5,Retail & Personal,Education & Training
31/05/2024,Visa Purchase                 29May Kmart 1167           Mount Bar,5.5,,8895.2,Retail & Personal,Retail (shopping)
31/05/2024,Eftpos Debit                  31May09:32 Bakery On O'Connell   North Adelaidsa Au,16.26,,8900.7,Food & Beverage,Food & Groceries
30/05/2024,Visa Purchase                 27May Bakery On O'Connell  North Ade,11.11,,8916.96,Food & Beverage,Food & Groceries
30/05/2024,Visa Purchase                 25May Sturt Football Club  Unley,10,,8928.07,Bills & Payments,Memberships
30/05/2024,Visa Purchase                 26May Mcdonalds Rndle Mall Adelaide,5.35,,8938.07,Food & Beverage,Dining out
30/05/2024,Visa Purchase                 27May Bunnings 337000      Prospect,3.6,,8943.42,Home & Property,Maintenance
30/05/2024,Eftpos Debit                  30May09:40 Uber* Trip\,12.46,,8947.02,Transport & Travel,Taxi & Rental car
30/05/2024,Tfr Wdl BPAY Internet         30May06:02 440057              City Of Adelaide,571.8,,8959.48,Bills & Payments,Tax payments
30/05/2024,Internet Deposit              30May06:01 From 0280074494440,,802.35,9531.28,Deposits,Deposit
29/05/2024,Visa Purchase                 26May Sporting Giftworks   Adelaide,14.95,,8728.93,Retail & Personal,Clothing & Shoes
29/05/2024,Visa Purchase                 25May Caledonian Hotel Nor North Ade,10,,8743.88,Food & Beverage,Dining out
29/05/2024,Andrew Kay Manag Wages 26052024,,210,8753.88,Income,Salary
28/05/2024,Visa Purchase                 24May Paper Tiger Adl      Adelaide,156.77,,8543.88,Food & Beverage,Dining out
28/05/2024,Visa Purchase                 24May Crown And Anchor Hot Adelaide,58.7,,8700.65,Food & Beverage,Dining out
28/05/2024,Visa Purchase                 25May Sq *Sturt Football C Unley,40,,8759.35,Entertainment & Recreation,Sports & Leisure
28/05/2024,Visa Purchase                 25May Sq *Sturt Football C Unley,30,,8799.35,Entertainment & Recreation,Sports & Leisure
28/05/2024,Visa Purchase                 25May Sq *Sturt Football C Unley,21,,8829.35,Entertainment & Recreation,Sports & Leisure
28/05/2024,Visa Purchase                 24May Crown And Anchor Hot Adelaide,18.21,,8850.35,Food & Beverage,Dining out
28/05/2024,Visa Purchase                 24May Bobo & Associates Pt Adelaide,13,,8868.56,Retail & Personal,Retail (shopping)
28/05/2024,Visa Purchase                 25May Ls Perrymans Bakery  North Ade,7.2,,8881.56,Food & Beverage,Food & Groceries
28/05/2024,Visa Purchase                 25May Sq *Hotdogs Unlimite Unley,7,,8888.76,Food & Beverage,Dining out
27/05/2024,Visa Purchase                 24May Lucia's Fine Foods   Adelaide,17.19,,8895.76,Food & Beverage,Food & Groceries
27/05/2024,Visa Purchase                 24May Nth Adel Foodland    North Ade,15.91,,8912.95,Food & Beverage,Food & Groceries
27/05/2024,Visa Purchase                 23May Telstra Prepaid      Melbourne,10,,8928.86,Bills & Payments,Telecommunications
27/05/2024,Visa Purchase                 23May Telstra Prepaid      Melbourne,10,,8938.86,Bills & Payments,Telecommunications
27/05/2024,Eftpos Debit                  26May15:13 Neuronau* Trip-Qk\,7.12,,8948.86,Transport & Travel,Vehicle Expenses
27/05/2024,Eftpos Debit                  26May04:10 Uber* Trip\,22.15,,8955.98,Transport & Travel,Taxi & Rental car
27/05/2024,Eftpos Debit                  26May01:37 Uber* Trip\,23.05,,8978.13,Transport & Travel,Taxi & Rental car
25/05/2024,Visa Purchase                 23May Nth Adel Foodland    North Ade,35.47,,9001.18,Food & Beverage,Food & Groceries
25/05/2024,Visa Purchase                 23May Nth Adel Foodland    North Ade,24.28,,9036.65,Food & Beverage,Food & Groceries
25/05/2024,Visa Purchase                 22May Woodside Foodland    Woodside,1.75,,9060.93,Food & Beverage,Food & Groceries
25/05/2024,Eftpos Debit                  25May08:47 Uber* Trip\,13.7,,9062.68,Transport & Travel,Taxi & Rental car
25/05/2024,Eftpos Debit                  25May06:19 Uber* Trip\,14.95,,9076.38,Transport & Travel,Taxi & Rental car
24/05/2024,Visa Purchase                 22May Smgb Mount Barker    Mount Bar,64.99,,9091.33,Bills & Payments,Gifts & Donations
24/05/2024,Visa Purchase                 22May Coles 4940           Mount Bar,9,,9156.32,Food & Beverage,Food & Groceries
24/05/2024,Visa Purchase                 22May Bakers Delight       Mount Bar,3.5,,9165.32,Food & Beverage,Food & Groceries
24/05/2024,Eftpos Debit                  24May09:29 Bakery On O'Connell   North Adelaidsa Au,16.16,,9168.82,Food & Beverage,Food & Groceries
23/05/2024,Visa Purchase                 21May 127 Days             Croydon P,23.8,,9184.98,Food & Beverage,Dining out
23/05/2024,Visa Purchase                 20May North Adelaide Haru  North Ade,10.2,,9208.78,Food & Beverage,Dining out
23/05/2024,Visa Purchase                 19May Ampol North Adelaide North Ade,3.6,,9218.98,Transport & Travel,Petrol
23/05/2024,Eftpos Debit                  23May07:04 Uber Eats* Eats\,4.58,,9222.58,Food & Beverage,Dining out
23/05/2024,Internet Deposit              23May06:03 From 0280074494440,,802.35,9227.16,Deposits,Deposit
22/05/2024,Visa Purchase                 20May Aware Women's Health North Ade,38.02,,8424.81,Retail & Personal,Medical & Personal care
22/05/2024,Visa Purchase                 19May Bakery On O'Connell  North Ade,27.27,,8462.83,Food & Beverage,Food & Groceries
22/05/2024,Visa Purchase                 20May Sq *Village Asian Gr North Ade,18.75,,8490.1,Food & Beverage,Food & Groceries
22/05/2024,Eftpos Credit                 22May19:05 Uber Eats* Eats\,,4.58,8508.85,Deposits,Deposit
22/05/2024,Eftpos Debit                  22May18:43 Uber Eats* Eats\,50.34,,8504.27,Food & Beverage,Dining out
21/05/2024,Visa Purchase                 18May Niku House           Adelaide,186.71,,8554.61,Food & Beverage,Dining out
21/05/2024,Visa Purchase                 19May Bws/123 Oconnell Str Nrth Adel,33,,8741.32,Food & Beverage,Beverages
21/05/2024,Visa Purchase                 18May Gilbert Street Hotel Adelaide,25.39,,8774.32,Food & Beverage,Beverages
21/05/2024,Visa Purchase                 19May Zlr*Metropolitan Fre North Ade,16.7,,8799.71,Food & Beverage,Food & Groceries
21/05/2024,Visa Purchase                 19May Neuronau* Temphold-Z Hawthorn,5.08,,8816.41,Transport & Travel,Vehicle Expenses
20/05/2024,Visa Purchase                 16May Costco Wholesale Aus Kilburn,42.97,,8821.49,Food & Beverage,Food & Groceries
20/05/2024,Visa Purchase                 17May Nth Adel Foodland    North Ade,10.23,,8864.46,Food & Beverage,Food & Groceries
20/05/2024,Eftpos Debit                  19May08:13 Uber* Trip\,15.21,,8874.69,Transport & Travel,Taxi & Rental car
20/05/2024,Eftpos Debit                  19May05:38 Uber* Trip\,16.03,,8889.9,Transport & Travel,Taxi & Rental car
18/05/2024,Visa Purchase                 15May Smp*Cafe  Fellini    North Ade,54.18,,8905.93,Food & Beverage,Dining out
18/05/2024,Visa Purchase                 16May Brighton & Seacliff  Seacliff,51,,8960.11,Food & Beverage,Dining out
18/05/2024,Visa Purchase                 16May Brighton & Seacliff  Seacliff,27,,9011.11,Food & Beverage,Dining out
18/05/2024,Visa Purchase                 16May Brighton & Seacliff  Seacliff,14,,9038.11,Food & Beverage,Dining out
18/05/2024,Visa Purchase                 14May Ampol North Adelaide North Ade,6.13,,9052.11,Transport & Travel,Petrol
17/05/2024,Visa Purchase                 15May Smgb Mount Barker    Mount Bar,64.99,,9058.24,Bills & Payments,Gifts & Donations
17/05/2024,Visa Purchase                 14May Aubergine S Fresh Pr Adelaide,14.06,,9123.23,Food & Beverage,Food & Groceries
17/05/2024,Visa Purchase                 14May Bobo & Associates Pt Adelaide,11.2,,9137.29,Retail & Personal,Retail (shopping)
17/05/2024,Visa Purchase                 14May Smp*Atlas Continenta Adelaide,10.17,,9148.49,Food & Beverage,Dining out
17/05/2024,Visa Purchase                 14May Hong Kong Grocery St Adelaide,6.98,,9158.66,Food & Beverage,Food & Groceries
17/05/2024,Eftpos Debit                  17May09:31 Bakery On O'Connell   North Adelaidsa Au,27.88,,9165.64,Food & Beverage,Food & Groceries
16/05/2024,Visa Purchase                 12May Adelaide Entertainme Hindmarsh,23.8,,9193.52,Food & Beverage,Dining out
16/05/2024,Visa Purchase                 14May Cappos Fish Market   Adelaide,18.7,,9217.32,Food & Beverage,Food & Groceries
16/05/2024,Visa Purchase                 14May Gt & Hg Pty Ltd      North Ade,13.25,,9236.02,Food & Beverage,Food & Groceries
16/05/2024,Internet Deposit              16May06:03 From 0280074494440,,802.35,9249.27,Deposits,Deposit
15/05/2024,Visa Purchase                 11May Tuno Aust Pty Ltd    North Ade,189,,8446.92,Food & Beverage,Dining out
15/05/2024,Visa Purchase                 13May Gn Circleoffriendsa  Summertow,51.63,,8635.92,Bills & Payments,Gifts & Donations
15/05/2024,Visa Purchase                 12May Nth Adel Foodland    North Ade,34.99,,8687.55,Food & Beverage,Food & Groceries
15/05/2024,Visa Purchase                 13May Nth Adel Foodland    North Ade,27.59,,8722.54,Food & Beverage,Food & Groceries
15/05/2024,Visa Purchase                 12May Wellington Hotel     North Ade,22.5,,8750.13,Food & Beverage,Beverages
14/05/2024,Visa Purchase                 10May Governor Hindmarsh H Hindmarsh,34,,8772.63,Food & Beverage,Beverages
14/05/2024,Visa Purchase                 11May La Chiva             Adelaide,24.34,,8806.63,Food & Beverage,Dining out
14/05/2024,Visa Purchase                 10May Governor Hindmarsh H Hindmarsh,22.8,,8830.97,Food & Beverage,Beverages
14/05/2024,Visa Purchase                 10May Grilld Pty Ltd - Run Adelaide,19.1,,8853.77,Food & Beverage,Dining out
14/05/2024,Visa Purchase                 11May Bakery On O'Connell  North Ade,11.11,,8872.87,Food & Beverage,Food & Groceries
14/05/2024,Eftpos Debit                  14May17:27 Neuronau* Trip-Je\,7.63,,8883.98,Transport & Travel,Vehicle Expenses
14/05/2024,Eftpos Debit                  14May15:34 Brow Threads & Lashes Adelaide     Sa Au,8.09,,8891.61,Retail & Personal,Medical & Personal care
14/05/2024,Eftpos Debit                  14May15:46 Neuronau* Trip-5E\,6.61,,8899.7,Transport & Travel,Vehicle Expenses
13/05/2024,Visa Purchase                 10May Sq *Bobibao          Bowden,75,,8906.31,Food & Beverage,Dining out
13/05/2024,Visa Purchase                 09May Color Club Pty Ltd   North Ade,70.7,,8981.31,Retail & Personal,Retail (shopping)
13/05/2024,Visa Purchase                 09May Telstra Prepaid      Melbourne,35,,9052.01,Bills & Payments,Telecommunications
13/05/2024,Visa Purchase                 10May Neuronau* Trip-Wd    Hawthorn,7.12,,9087.01,Transport & Travel,Vehicle Expenses
13/05/2024,Visa Purchase                 08May Aldi Stores - Mount  Mount Bar,3,,9094.13,Food & Beverage,Food & Groceries
13/05/2024,Eftpos Debit                  13May09:32 Uber* Trip\,11.92,,9097.13,Transport & Travel,Taxi & Rental car
11/05/2024,Visa Purchase                 07May Ampol North Adelaide North Ade,69.99,,9109.05,Transport & Travel,Petrol
11/05/2024,Visa Purchase                 09May Nth Adel Foodland    North Ade,36.13,,9179.04,Food & Beverage,Food & Groceries
11/05/2024,Visa Purchase                 09May Zlr*Metropolitan Fre North Ade,11.95,,9215.17,Food & Beverage,Food & Groceries
11/05/2024,Visa Purchase                 09May Sq *Village Asian Gr North Ade,8.4,,9227.12,Food & Beverage,Food & Groceries
11/05/2024,Foreign Currency Conversn Fee,0.1,,9235.52,Fees & Charges,Fees & Charges
11/05/2024,Visa Purchase O/Seas          07May Sgd2.99 Amznprimesg Membersh,3.35,,9235.62,Entertainment & Recreation,TV
11/05/2024,Eftpos Debit                  11May15:02 Neuronau* Trip-L6\,6.1,,9238.97,Transport & Travel,Vehicle Expenses
11/05/2024,Eftpos Debit                  11May10:26 Uber* Trip\,11.44,,9245.07,Transport & Travel,Taxi & Rental car
10/05/2024,Visa Purchase                 08May Lobethal Bakery      Lobethal,32.5,,9256.51,Food & Beverage,Food & Groceries
10/05/2024,Visa Purchase                 07May North Adelaide Haru  North Ade,10.2,,9289.01,Food & Beverage,Dining out
10/05/2024,Visa Purchase                 08May Smgb Mount Barker    Mount Bar,6.95,,9299.21,Bills & Payments,Gifts & Donations
10/05/2024,Visa Purchase                 08May Lobethal Bakery      Lobethal,3.8,,9306.16,Food & Beverage,Food & Groceries
10/05/2024,Eftpos Debit                  10May15:47 Neuronau* Trip-6H\,6.61,,9309.96,Transport & Travel,Vehicle Expenses
10/05/2024,Eftpos Debit                  10May09:29 Bakery On O'Connell   North Adelaidsa Au,11.41,,9316.57,Food & Beverage,Food & Groceries
9/05/2024,Visa Purchase                 06May Bakery On O'Connell  North Ade,11.11,,9327.98,Food & Beverage,Food & Groceries
9/05/2024,Visa Purchase                 07May Zlr*Metropolitan Fre North Ade,9.09,,9339.09,Food & Beverage,Food & Groceries
9/05/2024,Internet Deposit              09May06:03 From 0280074494440,,802.35,9348.18,Deposits,Deposit
8/05/2024,Visa Purchase                 05May Minimono Noodle Bar  Adelaide,26.95,,8545.83,Food & Beverage,Dining out
8/05/2024,Visa Purchase                 04May Nth Adel Foodland    North Ade,19.49,,8572.78,Food & Beverage,Food & Groceries
8/05/2024,Visa Purchase                 06May Nth Adel Foodland    North Ade,8.04,,8592.27,Food & Beverage,Food & Groceries
8/05/2024,Visa Purchase                 06May Sq *Bean2Heaven      Craigmore,6,,8600.31,Food & Beverage,Dining out
8/05/2024,Visa Purchase                 06May Bakers Delight       North Ade,3.5,,8606.31,Food & Beverage,Food & Groceries
8/05/2024,Andrew Kay Manag Wages 05052024,,469,8609.81,Income,Salary
8/05/2024,Eftpos Credit                 08May19:06 Uber Eats* Eats\,,49,8140.81,Deposits,Deposit
8/05/2024,Eftpos Debit                  08May19:04 Uber Eats* Eats\,49,,8091.81,Food & Beverage,Dining out
7/05/2024,Visa Purchase                 03May Hilton Adelaide      Adelaide,76.5,,8140.81,Transport & Travel,Hotels and Accommodation
7/05/2024,Visa Purchase                 03May Shout For Good Pty L Melbourne,50,,8217.31,Bills & Payments,Gifts & Donations
7/05/2024,Visa Purchase                 04May Ikea Pty Ltd         Tempe,26,,8267.31,Home & Property,Furnishings
7/05/2024,Visa Purchase                 05May Neuronau* Trip-1X    Hawthorn,6.61,,8293.31,Transport & Travel,Vehicle Expenses
7/05/2024,Visa Purchase                 05May Beam Mobility Austra -,5.59,,8299.92,Bills & Payments,Telecommunications
6/05/2024,Visa Purchase                 03May Sq *The Thai Guy     Adelaide,46,,8305.51,Entertainment & Recreation,Catering
6/05/2024,Internet Deposit              06May15:26 From 9000204517840,,4000,8351.51,Deposits,Deposit
4/05/2024,Visa Purchase                 02May Usafoods Aus         Moorabbin,62.69,,4351.51,Home & Property,Technology & Appliances
4/05/2024,Visa Purchase                 02May Nth Adel Foodland    North Ade,13.5,,4414.2,Food & Beverage,Food & Groceries
4/05/2024,Visa Purchase                 30Apr Aldi Stores - Kilbur Kilburn,6.01,,4427.7,Food & Beverage,Food & Groceries
4/05/2024,Eftpos Debit                  04May07:55 Uber* Trip\,14.06,,4433.71,Transport & Travel,Taxi & Rental car
3/05/2024,Visa Purchase                 30Apr Costco Wholesale Aus Kilburn,177.94,,4447.77,Food & Beverage,Food & Groceries
3/05/2024,Visa Purchase                 01May Patreon* Membership  Internet,36.85,,4625.71,Entertainment & Recreation,TV
3/05/2024,Visa Purchase                 30Apr Mitolo Coffee        Welland,28.34,,4662.56,Food & Beverage,Beverages
3/05/2024,Visa Purchase                 30Apr Bobo & Associates Pt Adelaide,12,,4690.9,Retail & Personal,Retail (shopping)
3/05/2024,Visa Purchase                 30Apr Smp*Aubergines       Adelaide,9.15,,4702.9,Food & Beverage,Food & Groceries
3/05/2024,Eftpos Debit                  03May18:59 Uber* Trip\,19.29,,4712.05,Transport & Travel,Taxi & Rental car
3/05/2024,Eftpos Debit                  03May16:20 Neuronau* Trip-2A\,7.12,,4731.34,Transport & Travel,Vehicle Expenses
3/05/2024,Atm Withdrawal                03May15:37 Banksa                Adelaide     5  Au,300,,4738.46,Withdrawals & Transfers,ATM & EFTPOS
3/05/2024,Eftpos Debit                  03May14:40 Neuronau* Trip-3E\,6.11,,5038.46,Transport & Travel,Vehicle Expenses
3/05/2024,Eftpos Debit                  03May09:36 Bakery On O'Connell   North Adelaidsa Au,21.52,,5044.57,Food & Beverage,Food & Groceries
3/05/2024,Eftpos Debit                  03May01:31 Uber Eats* Eats\,1.3,,5066.09,Food & Beverage,Dining out
2/05/2024,Visa Purchase                 28Apr Ampol North Adelaide North Ade,69.99,,5067.39,Transport & Travel,Petrol
2/05/2024,Visa Purchase                 29Apr Smp*Cafe  Fellini    North Ade,22.87,,5137.38,Food & Beverage,Dining out
2/05/2024,Visa Purchase                 30Apr Lucia's Fine Foods   Adelaide,17.19,,5160.25,Food & Beverage,Food & Groceries
2/05/2024,Visa Purchase                 29Apr Bakery On O'Connell  North Ade,11.11,,5177.44,Food & Beverage,Food & Groceries
2/05/2024,Visa Purchase                 30Apr Tafe Sa Regency Camp Adelaide,5.7,,5188.55,Retail & Personal,Education & Training
2/05/2024,Visa Purchase                 30Apr Nth Adel Foodland    North Ade,2.99,,5194.25,Food & Beverage,Food & Groceries
2/05/2024,Eftpos Credit                 02May13:32 Uber Eats* Eats\,,1.3,5197.24,Deposits,Deposit
2/05/2024,Eftpos Debit                  02May12:50 Uber Eats* Eats\,27.24,,5195.94,Food & Beverage,Dining out
2/05/2024,Internet Deposit              02May06:02 From 0280074494440,,802.35,5223.18,Deposits,Deposit
1/05/2024,Visa Purchase                 29Apr Nth Adel Foodland    North Ade,9,,4420.83,Food & Beverage,Food & Groceries
1/05/2024,Visa Purchase                 29Apr Sq *Bean2Heaven      Craigmore,6,,4429.83,Food & Beverage,Dining out
1/05/2024,Eftpos Debit                  01May10:31 Bakery On O'Connell   North Adelaidsa Au,30.51,,4435.83,Food & Beverage,Food & Groceries
1/05/2024,Eftpos Debit                  01May00:32 Hugh Hamilton Wines\,330,,4466.34,Bills & Payments,Gifts & Donations
30/04/2024,Visa Purchase                 27Apr Smp*The Flying Fig   North Ade,70,,4796.34,Food & Beverage,Food & Groceries
30/04/2024,Visa Purchase                 26Apr Smp*Brklyn Adelaide  Adelaide,19.31,,4866.34,Food & Beverage,Beverages
30/04/2024,Visa Purchase                 26Apr Crown And Anchor Hot Adelaide,18.21,,4885.65,Food & Beverage,Dining out
30/04/2024,Visa Purchase                 26Apr Crown And Anchor Hot Adelaide,18.21,,4903.86,Food & Beverage,Dining out
30/04/2024,Visa Purchase                 26Apr Foodworks North Adel North Ade,6.28,,4922.07,Food & Beverage,Food & Groceries
30/04/2024,Visa Purchase                 27Apr North Adelaide News  North Ade,5.95,,4928.35,Entertainment & Recreation,Books & Subscriptions
29/04/2024,Visa Purchase                 26Apr Brklyn               Adelaide,58.99,,4934.3,Food & Beverage,Beverages
29/04/2024,Visa Purchase                 26Apr Sq *Glam Medical Spa North Ade,45,,4993.29,Retail & Personal,Retail (shopping)
29/04/2024,Visa Purchase                 25Apr Bodymind Pty Ltd     Adelaide,15.3,,5038.29,Retail & Personal,Medical & Personal care
29/04/2024,Eftpos Debit                  29Apr01:03 Uber* Trip\,14.1,,5053.59,Transport & Travel,Taxi & Rental car
29/04/2024,Eftpos Debit                  28Apr11:48 Neuronau* Trip-Lv\,6.61,,5067.69,Transport & Travel,Vehicle Expenses
27/04/2024,Visa Purchase                 24Apr Nth Adel Foodland    North Ade,36.89,,5074.3,Food & Beverage,Food & Groceries
27/04/2024,Visa Purchase                 24Apr Color Club Pty Ltd   North Ade,25.25,,5111.19,Retail & Personal,Retail (shopping)
27/04/2024,Visa Purchase                 23Apr Wellington Hotel     North Ade,21,,5136.44,Food & Beverage,Beverages
27/04/2024,Visa Purchase                 24Apr Bakery On O'Connell  North Ade,18.99,,5157.44,Food & Beverage,Food & Groceries
27/04/2024,Visa Purchase                 23Apr Bakery On O'Connell  North Ade,15.15,,5176.43,Food & Beverage,Food & Groceries
27/04/2024,Visa Purchase                 23Apr Anzac Remembrance Ap Adelaide,10,,5191.58,Bills & Payments,Gifts & Donations
27/04/2024,Visa Purchase                 25Apr Daiso Rundle Mall    Adelaide,8.3,,5201.58,Retail & Personal,Retail (shopping)
27/04/2024,Visa Purchase                 25Apr Coles 4964           Adelaide,6,,5209.88,Food & Beverage,Food & Groceries
27/04/2024,Visa Purchase                 25Apr Neuronau* Temphold-V Hawthorn,4.06,,5215.88,Transport & Travel,Vehicle Expenses
27/04/2024,Eftpos Debit                  27Apr08:23 Uber* Trip\,13.54,,5219.94,Transport & Travel,Taxi & Rental car
27/04/2024,Eftpos Debit                  27Apr05:43 Uber* Trip\,15.07,,5233.48,Transport & Travel,Taxi & Rental car
26/04/2024,Visa Purchase                 20Apr Kunkun Pty Ltd       Melbourne,22.55,,5248.55,Food & Beverage,Dining out
26/04/2024,Visa Purchase                 20Apr Kunkun Pty Ltd       Melbourne,4.29,,5271.1,Food & Beverage,Dining out
26/04/2024,Visa Purchase                 23Apr Nth Adel Foodland    North Ade,2.35,,5275.39,Food & Beverage,Food & Groceries
26/04/2024,Eftpos Debit                  26Apr09:32 Bakery On O'Connell   North Adelaidsa Au,27.88,,5277.74,Food & Beverage,Food & Groceries
26/04/2024,Eftpos Debit                  25Apr16:54 Neuronau* Trip-Me\,6.1,,5305.62,Transport & Travel,Vehicle Expenses
26/04/2024,Internet Deposit              25Apr06:03 From 0280074494440,,802.35,5311.72,Deposits,Deposit
24/04/2024,Visa Purchase                 20Apr Uber   *Trip         Sydney,76.72,,4509.37,Transport & Travel,Taxi & Rental car
24/04/2024,Visa Purchase                 22Apr Nth Adel Foodland    North Ade,64.31,,4586.09,Food & Beverage,Food & Groceries
24/04/2024,Visa Purchase                 20Apr Happy Star Two Pty L Melbourne,14.29,,4650.4,Food & Beverage,Dining out
24/04/2024,Visa Purchase                 22Apr Zlr*Haru Sushi       North Ade,10.9,,4664.69,Food & Beverage,Dining out
24/04/2024,Eftpos Debit                  24Apr13:02 Www.Gelatomessina.Com\,68,,4675.59,Food & Beverage,Dining out
23/04/2024,Visa Purchase                 19Apr David Jones Limited  Melbourne,559.96,,4743.59,Retail & Personal,Retail (shopping)
23/04/2024,Visa Purchase                 20Apr Uber* Trip           Sydney,79.48,,5303.55,Transport & Travel,Taxi & Rental car
23/04/2024,Visa Purchase                 21Apr Shanghai Street Xlb  Melbourne,74.77,,5383.03,Food & Beverage,Dining out
23/04/2024,Visa Purchase                 18Apr Uber   *Trip         Sydney,63.71,,5457.8,Transport & Travel,Taxi & Rental car
23/04/2024,Visa Purchase                 20Apr Sq *Hamilton's Hospi Southbank,27.3,,5521.51,Entertainment & Recreation,Catering
23/04/2024,Visa Purchase                 20Apr Sq *Hamilton's Hospi Strathfie,26.29,,5548.81,Entertainment & Recreation,Catering
23/04/2024,Visa Purchase                 19Apr Sq *Maker Little Bou Melbourne,18.5,,5575.1,Food & Beverage,Dining out
23/04/2024,Visa Purchase                 20Apr Sq *Overlay Coffee   Melbourne,13.3,,5593.6,Food & Beverage,Beverages
22/04/2024,Visa Purchase                 17Apr Targett Medical Pty  North Ade,1134,,5606.9,Retail & Personal,Retail (shopping)
22/04/2024,Visa Purchase                 18Apr Doma Kitchen         Melbourne,77.52,,6740.9,Food & Beverage,Dining out
22/04/2024,Visa Purchase                 19Apr Downtown Grocer      Melbourne,24.2,,6818.42,Food & Beverage,Food & Groceries
22/04/2024,Visa Purchase                 17Apr Foodworks North Adel North Ade,14.82,,6842.62,Food & Beverage,Food & Groceries
22/04/2024,Visa Purchase                 19Apr French Fix Pty Ltd   Melbourne,13.16,,6857.44,Food & Beverage,Dining out
22/04/2024,Visa Purchase                 18Apr Bakery On O'Connell  North Ade,13.13,,6870.6,Food & Beverage,Food & Groceries
22/04/2024,Visa Purchase                 19Apr French Fix Pty Ltd   Melbourne,5.06,,6883.73,Food & Beverage,Dining out
22/04/2024,Eftpos Debit                  22Apr09:31 Bakery On O'Connell   North Adelaidsa Au,27.88,,6888.79,Food & Beverage,Food & Groceries
22/04/2024,Eftpos Debit                  22Apr03:40 Uber* Trip\,31.56,,6916.67,Transport & Travel,Taxi & Rental car
20/04/2024,Visa Purchase                 16Apr Aldi Stores - Prospe Prospect,32.63,,6948.23,Food & Beverage,Food & Groceries
20/04/2024,Visa Purchase                 17Apr Cibo Espresso T And  North Ade,11.7,,6980.86,Food & Beverage,Dining out
20/04/2024,Visa Purchase                 17Apr Bakery On O'Connell  North Ade,11.11,,6992.56,Food & Beverage,Food & Groceries
20/04/2024,Visa Purchase                 18Apr Cocacolaepp          Adelaide,3.8,,7003.67,Food & Beverage,Food & Groceries
19/04/2024,Visa Purchase                 16Apr Kanika Group Pty Ltd Prospect,110.47,,7007.47,Transport & Travel,Vehicle Expenses
19/04/2024,Visa Purchase                 16Apr Telstra Prepaid      Melbourne,10,,7117.94,Bills & Payments,Telecommunications
19/04/2024,Visa Purchase                 17Apr Nth Adel Foodland    North Ade,0.1,,7127.94,Food & Beverage,Food & Groceries
19/04/2024,Tfr Wdl BPAY Internet         19Apr06:04 500015101768        Origin Energy,1660,,7128.04,Bills & Payments,Utilities & Rates
19/04/2024,Internet Deposit              19Apr06:02 From 0280074494440,,802.35,8788.04,Deposits,Deposit
19/04/2024,Eftpos Debit                  19Apr03:30 Uber* Trip\,29.02,,7985.69,Transport & Travel,Taxi & Rental car
18/04/2024,Visa Purchase                 13Apr Amazon Marketplace A Sydney So,165.4,,8014.71,Retail & Personal,Retail (shopping)
18/04/2024,Visa Purchase                 13Apr Krung Thep           North Ade,84.5,,8180.11,Food & Beverage,Dining out
18/04/2024,Visa Purchase                 16Apr Nth Adel Foodland    North Ade,12.19,,8264.61,Food & Beverage,Food & Groceries
18/04/2024,Eftpos Debit                  18Apr00:36 Uber* Trip\,16.2,,8276.8,Transport & Travel,Taxi & Rental car
17/04/2024,Visa Credit                   13Apr Nth Adel Foodland    North Ade,,3.1,8293,Deposits,Deposit
17/04/2024,Visa Purchase                 13Apr Nth Adel Foodland    North Ade,21.3,,8289.9,Food & Beverage,Food & Groceries
17/04/2024,Visa Purchase                 14Apr Bakery On O'Connell  North Ade,18.79,,8311.2,Food & Beverage,Food & Groceries
17/04/2024,Visa Purchase                 14Apr Nth Adel Foodland    North Ade,14.29,,8329.99,Food & Beverage,Food & Groceries
17/04/2024,Eftpos Debit                  17Apr11:51 Idodrivethru.Com.Au\,550,,8344.28,Home & Property,Services & Tradespeople
16/04/2024,Visa Purchase                 13Apr Gn Circleoffriendsa  Summertow,51.63,,8894.28,Bills & Payments,Gifts & Donations
16/04/2024,Visa Purchase                 12Apr Governor Hindmarsh H Hindmarsh,22.8,,8945.91,Food & Beverage,Beverages
16/04/2024,Visa Purchase                 12Apr Governor Hindmarsh H Hindmarsh,22.8,,8968.71,Food & Beverage,Beverages
16/04/2024,Visa Purchase                 14Apr Sq *Village Asian Gr North Ade,6.5,,8991.51,Food & Beverage,Food & Groceries
16/04/2024,Visa Purchase                 12Apr Bakery On O'Connell  North Ade,6.06,,8998.01,Food & Beverage,Food & Groceries
16/04/2024,Visa Purchase                 13Apr Woodside Foodland    Woodside,2.82,,9004.07,Food & Beverage,Food & Groceries
16/04/2024,Eftpos Debit                  16Apr21:22 Kx Pilates Nth Adelaide\,560,,9006.89,Retail & Personal,Health & Fitness
15/04/2024,Visa Purchase                 11Apr Costco Wholesale Aus Kilburn,204.18,,9566.89,Food & Beverage,Food & Groceries
15/04/2024,Visa Purchase                 11Apr Scootaround Australi Fulham,195,,9771.07,Transport & Travel,Vehicle Expenses
15/04/2024,Visa Purchase                 12Apr V/Cellars 3327       N Adelaid,47.5,,9966.07,Food & Beverage,Beverages
15/04/2024,Visa Purchase                 10Apr Telstra Prepaid      Melbourne,35,,10013.57,Bills & Payments,Telecommunications
15/04/2024,Visa Purchase                 11Apr Color Club Pty Ltd   North Ade,25.25,,10048.57,Retail & Personal,Retail (shopping)
15/04/2024,Visa Purchase                 12Apr Sq *Fun2Seeya Pizzer Queenstow,24,,10073.82,Food & Beverage,Food & Groceries
15/04/2024,Visa Purchase                 12Apr Sq *Plant 3 Downstai Bowden,22,,10097.82,Food & Beverage,Beverages
15/04/2024,Visa Purchase                 11Apr Crown And Anchor Hot Adelaide,20.24,,10119.82,Food & Beverage,Dining out
15/04/2024,Visa Purchase                 11Apr Crown And Anchor Hot Adelaide,9.1,,10140.06,Food & Beverage,Dining out
15/04/2024,Oakbank Racing C Pay For 4/15/2024,,224.3,10149.16,Deposits,Deposit
13/04/2024,Visa Purchase                 11Apr Bunningssausagesizzl Hawthorn,3.5,,9924.86,Home & Property,Maintenance
13/04/2024,Eftpos Debit                  13Apr10:20 Uber* Trip\,11.8,,9928.36,Transport & Travel,Taxi & Rental car
12/04/2024,Visa Purchase                 10Apr Elysian Salon & Spa  Adelaide,410.5,,9940.16,Retail & Personal,Retail (shopping)
12/04/2024,Visa Purchase                 10Apr Usafoods Aus         Moorabbin,44.95,,10350.66,Home & Property,Technology & Appliances
12/04/2024,Visa Purchase                 10Apr Guzman Y Gomez       Adelaide,19.7,,10395.61,Food & Beverage,Dining out
12/04/2024,Visa Purchase                 10Apr Alh Venues/123 Oconn Nrth Adel,12,,10415.31,Transport & Travel,Hotels and Accommodation
12/04/2024,Visa Purchase                 10Apr Woolworths/80-88 Run Rundle Ma,8,,10427.31,Food & Beverage,Food & Groceries
12/04/2024,Visa Purchase                 10Apr Beam Mobility Austra -,6.61,,10435.31,Bills & Payments,Telecommunications
12/04/2024,Eftpos Debit                  12Apr15:07 Endota North Adelaide North Adelaid   Au,145,,10441.92,Retail & Personal,Medical & Personal care
12/04/2024,Eftpos Debit                  12Apr09:36 Bakery On O'Connell   North Adelaidsa Au,22.83,,10586.92,Food & Beverage,Food & Groceries
12/04/2024,Eftpos Debit                  12Apr08:33 Uber* Trip\,19.15,,10609.75,Transport & Travel,Taxi & Rental car
12/04/2024,Eftpos Debit                  12Apr06:18 Uber* Trip\,14.52,,10628.9,Transport & Travel,Taxi & Rental car
12/04/2024,Internet Deposit              12Apr06:04 From 0280074494440,,802.35,10643.42,Deposits,Deposit
12/04/2024,Eftpos Debit                  12Apr02:40 Uber* Trip\,28.28,,9841.07,Transport & Travel,Taxi & Rental car
11/04/2024,Visa Purchase                 09Apr Nth Adel Foodland    North Ade,86.41,,9869.35,Food & Beverage,Food & Groceries
11/04/2024,Visa Purchase                 09Apr Alh Venues/123 Oconn Nrth Adel,20.2,,9955.76,Transport & Travel,Hotels and Accommodation
11/04/2024,Visa Purchase                 09Apr Zlr*Haru Sushi       North Ade,10.9,,9975.96,Food & Beverage,Dining out
11/04/2024,Visa Purchase                 09Apr Bakers Delight       North Ade,5.5,,9986.86,Food & Beverage,Food & Groceries
11/04/2024,Foreign Currency Conversn Fee,0.1,,9992.36,Fees & Charges,Fees & Charges
11/04/2024,Visa Purchase O/Seas          07Apr Sgd2.99 Amznprimesg Membersh,3.38,,9992.46,Entertainment & Recreation,TV
11/04/2024,Eftpos Debit                  11Apr21:36 Uber* Trip\,28.88,,9995.84,Transport & Travel,Taxi & Rental car
11/04/2024,Tfr Wdl BPAY Internet         11Apr12:06 0207782150          Sa Water,169.37,,10024.72,Bills & Payments,Utilities & Rates
10/04/2024,Foreign Currency Conversn Fee,0.79,,10194.09,Fees & Charges,Fees & Charges
10/04/2024,Visa Purchase O/Seas          07Apr Hkd136.00 Relay Hkgr21,26.54,,10194.88,Retail & Personal,Clothing & Shoes
10/04/2024,Eftpos Debit                  10Apr16:56 Neuronau* Trip-Xb\,8.14,,10221.42,Transport & Travel,Vehicle Expenses
10/04/2024,Eftpos Debit                  10Apr16:00 Brow Threads & Lashes Adelaide     Sa Au,20.22,,10229.56,Retail & Personal,Medical & Personal care
9/04/2024,Foreign Currency Conversn Fee,0.7,,10249.78,Fees & Charges,Fees & Charges
9/04/2024,Visa Purchase O/Seas          07Apr Hkd120.00 Yedpay * Morning Glo,23.41,,10250.48,Food & Beverage,Food & Groceries
9/04/2024,Foreign Currency Conversn Fee,0.65,,10273.89,Fees & Charges,Fees & Charges
9/04/2024,"Visa Purchase O/Seas          07Apr Hkd112.50 7-Eleven, Hk (1295)",21.95,,10274.54,Food & Beverage,Food & Groceries
9/04/2024,Foreign Currency Conversn Fee,0.46,,10296.49,Fees & Charges,Fees & Charges
9/04/2024,Visa Purchase O/Seas          06Apr Hkd80.00 Yedpay * Morning Glo,15.61,,10296.95,Food & Beverage,Food & Groceries
9/04/2024,Visa Purchase                 04Apr Delaware North Retai Adelaide,5.9,,10312.56,Transport & Travel,Hotels and Accommodation
9/04/2024,Foreign Currency Conversn Fee,0.17,,10318.46,Fees & Charges,Fees & Charges
9/04/2024,Visa Purchase O/Seas          05Apr Hkd30.00 Queen Victoria,5.85,,10318.63,Food & Beverage,Beverages
9/04/2024,Eftpos Debit                  09Apr14:25 Bakery On O'Connell   North Adelaidsa Au,11.11,,10324.48,Food & Beverage,Food & Groceries
9/04/2024,Eftpos Debit                  09Apr07:32 Uber Eats* Eats\,6.14,,10335.59,Food & Beverage,Dining out
9/04/2024,Eftpos Debit                  09Apr02:02 Uber* Trip\,32.29,,10341.73,Transport & Travel,Taxi & Rental car
8/04/2024,Foreign Currency Conversn Fee,1.69,,10374.02,Fees & Charges,Fees & Charges
8/04/2024,Visa Purchase O/Seas          05Apr Hkd290.00 Hong Kong Stadium571,56.52,,10375.71,Transport & Travel,Hotels and Accommodation
8/04/2024,Foreign Currency Conversn Fee,0.57,,10432.23,Fees & Charges,Fees & Charges
8/04/2024,Visa Purchase O/Seas          05Apr Hkd99.00 Uniqlo Hong Kong Ltd,19.29,,10432.8,Retail & Personal,Clothing & Shoes
8/04/2024,Foreign Currency Conversn Fee,0.49,,10452.09,Fees & Charges,Fees & Charges
8/04/2024,Visa Purchase O/Seas          05Apr Hkd85.00 Maison Eric Kayser,16.57,,10452.58,Food & Beverage,Food & Groceries
8/04/2024,Visa Purchase                 04Apr Telstra Prepaid      Melbourne,15,,10469.15,Bills & Payments,Telecommunications
8/04/2024,Foreign Currency Conversn Fee,0.38,,10484.15,Fees & Charges,Fees & Charges
8/04/2024,Visa Purchase O/Seas          05Apr Hkd65.00 Sa Sa Cosmetic Co. L,12.67,,10484.53,Retail & Personal,Retail (shopping)
8/04/2024,Visa Purchase                 04Apr 100 Miles            Adelaide,6.06,,10497.2,Food & Beverage,Dining out
8/04/2024,Osko Withdrawal               08Apr20:26 S Sequeira,150,,10503.26,Withdrawals & Transfers,Withdrawal
8/04/2024,Eftpos Credit                 08Apr19:33 Uber Eats* Eats\,,6.14,10653.26,Deposits,Deposit
8/04/2024,Eftpos Debit                  08Apr18:31 Uber Eats* Eats\,67.57,,10647.12,Food & Beverage,Dining out
6/04/2024,Visa Purchase                 03Apr Color Club Pty Ltd   North Ade,45.45,,10714.69,Retail & Personal,Retail (shopping)
5/04/2024,Visa Purchase                 03Apr Howards Storage Worl Mile End,43.95,,10760.14,Food & Beverage,Food & Groceries
5/04/2024,Visa Purchase                 03Apr Howards Storage Worl Mile End,39.95,,10804.09,Food & Beverage,Food & Groceries
5/04/2024,Visa Purchase                 02Apr North Adelaide Haru  North Ade,10.2,,10844.04,Food & Beverage,Dining out
5/04/2024,Visa Purchase                 03Apr Nth Adel Foodland    North Ade,7.6,,10854.24,Food & Beverage,Food & Groceries
5/04/2024,Visa Purchase                 02Apr Bakery On O'Connell  North Ade,6.06,,10861.84,Food & Beverage,Food & Groceries
5/04/2024,Visa Purchase                 03Apr Bakers Delight       North Ade,3.5,,10867.9,Food & Beverage,Food & Groceries
5/04/2024,Internet Deposit              05Apr06:03 From 0280074494440,,802.35,10871.4,Deposits,Deposit
4/04/2024,Visa Purchase                 31Mar Foodworks North Adel North Ade,33.51,,10069.05,Food & Beverage,Food & Groceries
4/04/2024,Visa Purchase                 01Apr Bakery On O'Connell  North Ade,20.91,,10102.56,Food & Beverage,Food & Groceries
4/04/2024,Visa Purchase                 02Apr Tafe Sa Regency Camp Adelaide,5.7,,10123.47,Retail & Personal,Education & Training
4/04/2024,Eftpos Debit                  04Apr20:19 Uber* Trip\,27.27,,10129.17,Transport & Travel,Taxi & Rental car
3/04/2024,Visa Purchase                 29Mar Ampol North Adelaide North Ade,69.99,,10156.44,Transport & Travel,Petrol
3/04/2024,Visa Purchase                 01Apr Patreon* Membership  Internet,36.85,,10226.43,Entertainment & Recreation,TV
3/04/2024,Visa Purchase                 29Mar Bakery On O'Connell  North Ade,21.52,,10263.28,Food & Beverage,Food & Groceries
3/04/2024,Visa Purchase                 28Mar Ampol North Adelaide North Ade,7.26,,10284.8,Transport & Travel,Petrol
3/04/2024,Visa Purchase                 30Mar David Alan Coppock   Seacliff,6.6,,10292.06,Food & Beverage,Dining out
3/04/2024,Visa Purchase                 28Mar Foodworks North Adel North Ade,5.69,,10298.66,Food & Beverage,Food & Groceries
3/04/2024,Visa Purchase                 31Mar Neuronau* Temphold-N Hawthorn,5.08,,10304.35,Transport & Travel,Vehicle Expenses
3/04/2024,Visa Purchase                 01Apr Zlr*Owners & Trainer Oakbank,5,,10309.43,Bills & Payments,Memberships
2/04/2024,Visa Purchase                 27Mar Bettys Burgers Austr Adelaide,30.5,,10314.43,Food & Beverage,Dining out
2/04/2024,Visa Purchase                 28Mar Nth Adel Foodland    North Ade,30.26,,10344.93,Food & Beverage,Food & Groceries
2/04/2024,Visa Purchase                 27Mar Kim Wang Supermarket Adelaide,22.48,,10375.19,Food & Beverage,Food & Groceries
2/04/2024,Visa Purchase                 27Mar Angelakis Bros       Adelaide,12.49,,10397.67,Food & Beverage,Food & Groceries
2/04/2024,Visa Purchase                 27Mar Foodworks North Adel North Ade,11.45,,10410.16,Food & Beverage,Food & Groceries
2/04/2024,Visa Purchase                 27Mar Bobo & Associates Pt Adelaide,8,,10421.61,Retail & Personal,Retail (shopping)
2/04/2024,Visa Purchase                 28Mar Tafe Sa Regency Camp Adelaide,7,,10429.61,Retail & Personal,Education & Training
2/04/2024,Visa Purchase                 28Mar Costco Wholesale Aus Kilburn,5.99,,10436.61,Food & Beverage,Food & Groceries
2/04/2024,Visa Purchase                 27Mar Rundle Street Conven Adelaide,5.25,,10442.6,Food & Beverage,Food & Groceries
2/04/2024,Visa Purchase                 28Mar Tafe Sa Regency Camp Adelaide,3,,10447.85,Retail & Personal,Education & Training
2/04/2024,Visa Purchase                 28Mar Post North Adelaide  North Ade,1.29,,10450.85,Bills & Payments,Professional & Govt services
2/04/2024,Oakbank Racing C Pay For 4/1/2024,,298.4,10452.14,Deposits,Deposit
30/03/2024,Visa Purchase                 22Mar Globale /Only Ny     Melbourne,203,,10153.74,Retail & Personal,Clothing & Shoes
30/03/2024,Visa Purchase                 28Mar Origin Energy Ltd    Barangaro,153.09,,10356.74,Bills & Payments,Utilities & Rates
30/03/2024,Visa Purchase                 26Mar Smp*Cafe Fellini     North Ade,33.34,,10509.83,Food & Beverage,Dining out
30/03/2024,Visa Purchase                 27Mar Palace Nova Eastend  Adelaide,23,,10543.17,Entertainment & Recreation,TV
30/03/2024,Visa Purchase                 25Mar Foodworks North Adel North Ade,14.38,,10566.17,Food & Beverage,Food & Groceries
30/03/2024,Visa Purchase                 26Mar Bakery On O'Connell  North Ade,11.11,,10580.55,Food & Beverage,Food & Groceries
30/03/2024,Visa Purchase                 27Mar Palace Nova Eastend  Adelaide,9,,10591.66,Entertainment & Recreation,TV
30/03/2024,Osko Withdrawal               29Mar10:22 K Payfer 2023 1040 Rj Brukwinski,600,,10600.66,Withdrawals & Transfers,Withdrawal
30/03/2024,Internet Deposit              29Mar06:04 From 0280074494440,,802.35,11200.66,Deposits,Deposit
28/03/2024,Visa Purchase                 25Mar Bakery On O'Connell  North Ade,23.23,,10398.31,Food & Beverage,Food & Groceries
28/03/2024,Visa Purchase                 26Mar Nth Adel Foodland    North Ade,6.8,,10421.54,Food & Beverage,Food & Groceries
28/03/2024,Visa Purchase                 26Mar Tafe Sa Regency Camp Adelaide,5.7,,10428.34,Retail & Personal,Education & Training
28/03/2024,Eftpos Debit                  28Mar10:58 Bakery On O'Connell   North Adelaidsa Au,11.11,,10434.04,Food & Beverage,Food & Groceries
28/03/2024,Eftpos Debit                  28Mar11:20 Sq *Tynte Street Qualinorth Adelaidsa Au,80.85,,10445.15,Food & Beverage,Food & Groceries
28/03/2024,Eftpos Debit                  28Mar09:58 Uber* Trip\,13.35,,10526,Transport & Travel,Taxi & Rental car
27/03/2024,Deft Payments Deft      22346207,942.99,,10539.35,Bills & Payments,Expenses & Payments
27/03/2024,Visa Purchase                 23Mar Krung Thep           North Ade,69.5,,11482.34,Food & Beverage,Dining out
27/03/2024,Visa Purchase                 25Mar Nth Adel Foodland    North Ade,39.52,,11551.84,Food & Beverage,Food & Groceries
27/03/2024,Visa Purchase                 25Mar Ls Perrymans Bakery  North Ade,9.5,,11591.36,Food & Beverage,Food & Groceries
27/03/2024,Visa Purchase                 25Mar Sq *Bean2Heaven      Craigmore,6,,11600.86,Food & Beverage,Dining out
27/03/2024,Eftpos Debit                  27Mar18:50 Neuronau* Trip-Yt\,6.61,,11606.86,Transport & Travel,Vehicle Expenses
26/03/2024,Visa Purchase                 23Mar Woodside Foodland    Woodside,62.56,,11613.47,Food & Beverage,Food & Groceries
26/03/2024,Visa Purchase                 23Mar Smp*The Flying Fig   North Ade,27.2,,11676.03,Food & Beverage,Food & Groceries
26/03/2024,Visa Purchase                 23Mar Sq *Team Enzo        Mile End,8.5,,11703.23,Food & Beverage,Food & Groceries
25/03/2024,Visa Purchase                 22Mar Nth Adel Foodland    North Ade,42.5,,11711.73,Food & Beverage,Food & Groceries
25/03/2024,Visa Purchase                 22Mar Sq *Hsmh Main Bar    Adelaide,29,,11754.23,Entertainment & Recreation,Sports & Leisure
25/03/2024,Visa Purchase                 22Mar Hm Bagels            Banksia P,18,,11783.23,Food & Beverage,Food & Groceries
25/03/2024,Visa Purchase                 20Mar Telstra Prepaid      Melbourne,10,,11801.23,Bills & Payments,Telecommunications
25/03/2024,Osko Withdrawal               25Mar12:32 01791 Miriam Errington Conveyancing,150,,11811.23,Withdrawals & Transfers,Withdrawal
23/03/2024,Visa Purchase                 21Mar Nth Adel Foodland    North Ade,45.62,,11961.23,Food & Beverage,Food & Groceries
23/03/2024,Visa Purchase                 21Mar Burgastronomy        North Ade,26.8,,12006.85,Food & Beverage,Dining out
23/03/2024,Visa Purchase                 21Mar Tafe Sa Regency Camp Adelaide,4,,12033.65,Retail & Personal,Education & Training
23/03/2024,Eftpos Debit                  23Mar10:06 Uber* Trip\,20.25,,12037.65,Transport & Travel,Taxi & Rental car
23/03/2024,Eftpos Debit                  23Mar06:15 Uber* Trip\,15.26,,12057.9,Transport & Travel,Taxi & Rental car
22/03/2024,Visa Purchase                 19Mar Bunnings 337000      Prospect,110,,12073.16,Home & Property,Maintenance
22/03/2024,Visa Purchase                 19Mar Costco Wholesale Aus Kilburn,106.95,,12183.16,Food & Beverage,Food & Groceries
22/03/2024,Visa Purchase                 20Mar Nth Adel Foodland    North Ade,18.87,,12290.11,Food & Beverage,Food & Groceries
22/03/2024,Visa Purchase                 20Mar Beam Mobility Austra -,6.9,,12308.98,Bills & Payments,Telecommunications
22/03/2024,Visa Purchase                 20Mar Neuronau* Temphold-K Hawthorn,5.6,,12315.88,Transport & Travel,Vehicle Expenses
21/03/2024,Visa Purchase                 17Mar Uber   *Trip         Sydney,78.96,,12321.48,Transport & Travel,Taxi & Rental car
21/03/2024,Visa Purchase                 18Mar Bunnings Group Ltd   Hawthorn,34.41,,12400.44,Home & Property,Maintenance
21/03/2024,Visa Purchase                 19Mar Sq *Village Asian Gr North Ade,23.8,,12434.85,Food & Beverage,Food & Groceries
21/03/2024,Visa Purchase                 19Mar Nth Adel Foodland    North Ade,7.2,,12458.65,Food & Beverage,Food & Groceries
20/03/2024,Visa Purchase                 16Mar Otter Products Austr 852 3760,99.95,,12465.85,Home & Property,Technology & Appliances
20/03/2024,Visa Purchase                 16Mar Nth Adel Foodland    North Ade,74.5,,12565.8,Food & Beverage,Food & Groceries
20/03/2024,Visa Purchase                 16Mar Central Market Gourm Adelaide,16.11,,12640.3,Food & Beverage,Food & Groceries
20/03/2024,Visa Purchase                 18Mar Ls Perrymans Bakery  North Ade,15.6,,12656.41,Food & Beverage,Food & Groceries
20/03/2024,Visa Purchase                 16Mar Skala Bakery         Adelaide,8.5,,12672.01,Food & Beverage,Food & Groceries
20/03/2024,Visa Purchase                 16Mar Bean Bar Kws         Adelaide,3.5,,12680.51,Food & Beverage,Food & Groceries
20/03/2024,Andrew Kay Manag Wages 17032024,,2040.62,12684.01,Income,Salary
20/03/2024,Eftpos Debit                  20Mar14:57 Jeff Ramsey Pharmac\North Adelaide    Au,20.98,,10643.39,Retail & Personal,Medical & Personal care
19/03/2024,Visa Credit                   15Mar Bunnings Group Ltd   Hawthorn,,20.57,10664.37,Deposits,Deposit
19/03/2024,Visa Purchase                 15Mar Smokelovers          Adelaide,61,,10643.8,Food & Beverage,Beverages
19/03/2024,Visa Purchase                 15Mar Smokelovers          Adelaide,48,,10704.8,Food & Beverage,Beverages
19/03/2024,Visa Purchase                 14Mar Telstra Limited      Adelaide,35,,10752.8,Bills & Payments,Telecommunications
19/03/2024,Visa Purchase                 16Mar The Coffee Bean Shop Welland,27.74,,10787.8,Food & Beverage,Beverages
19/03/2024,Visa Purchase                 17Mar Sq *Gluttony Food &  Magill,22,,10815.54,Entertainment & Recreation,Catering
19/03/2024,Visa Purchase                 15Mar Bunnings Group Ltd   Hawthorn,20.57,,10837.54,Home & Property,Maintenance
19/03/2024,Visa Purchase                 15Mar Smokelovers          Adelaide,13,,10858.11,Food & Beverage,Beverages
19/03/2024,Visa Purchase                 16Mar House Of Health Coll Adelaide,8.75,,10871.11,Food & Beverage,Food & Groceries
19/03/2024,Visa Purchase                 16Mar Beam Mobility Austra -,7.49,,10879.86,Bills & Payments,Telecommunications
19/03/2024,Visa Purchase                 16Mar Woodside Foodland    Woodside,3.5,,10887.35,Food & Beverage,Food & Groceries
18/03/2024,Visa Purchase                 14Mar Telstra Services     Melbourne,699,,10890.85,Bills & Payments,Telecommunications
18/03/2024,Visa Purchase                 14Mar Smp*The Flying Fig   North Ade,66.1,,11589.85,Food & Beverage,Food & Groceries
18/03/2024,Eftpos Debit                  18Mar05:15 Uber* Trip\,17.04,,11655.95,Transport & Travel,Taxi & Rental car
18/03/2024,Eftpos Debit                  18Mar02:39 Uber* Trip\,14.62,,11672.99,Transport & Travel,Taxi & Rental car
18/03/2024,Eftpos Debit                  17Mar12:12 Uber* Trip\,19.93,,11687.61,Transport & Travel,Taxi & Rental car
16/03/2024,Visa Purchase                 14Mar Usafoods Aus         Moorabbin,70.45,,11707.54,Home & Property,Technology & Appliances
16/03/2024,Visa Purchase                 13Mar Governor Hindmarsh H Hindmarsh,22.8,,11777.99,Food & Beverage,Beverages
16/03/2024,Visa Purchase                 13Mar Governor Hindmarsh H Hindmarsh,22.8,,11800.79,Food & Beverage,Beverages
16/03/2024,Visa Purchase                 13Mar Governor Hindmarsh H Hindmarsh,22.8,,11823.59,Food & Beverage,Beverages
16/03/2024,Visa Purchase                 14Mar Tafe Sa Regency Camp Adelaide,7,,11846.39,Retail & Personal,Education & Training
16/03/2024,Visa Purchase                 14Mar Beam Mobility Austra -,6.9,,11853.39,Bills & Payments,Telecommunications
16/03/2024,Eftpos Debit                  16Mar12:09 Neuronau* Trip-Ww\,6.5,,11860.29,Transport & Travel,Vehicle Expenses
15/03/2024,Visa Purchase                 13Mar Gn Circleoffriendsa  Summertow,51.63,,11866.79,Bills & Payments,Gifts & Donations
15/03/2024,Visa Purchase                 13Mar Nth Adel Foodland    North Ade,33.07,,11918.42,Food & Beverage,Food & Groceries
15/03/2024,Eftpos Debit                  15Mar17:56 Neuronau* Trip-9U\,9.45,,11951.49,Transport & Travel,Vehicle Expenses
15/03/2024,Eftpos Debit                  15Mar14:19 Sq *Color Club        North Adelaidsa Au,68.18,,11960.94,Retail & Personal,Retail (shopping)
15/03/2024,Osko Withdrawal               15Mar11:28 Me01791 Miriam Errington Conveyancing,1520.32,,12029.12,Withdrawals & Transfers,Withdrawal
15/03/2024,Eftpos Debit                  15Mar09:30 Bakery On O'Connell   North Adelaidsa Au,10.91,,13549.44,Food & Beverage,Food & Groceries
14/03/2024,Visa Purchase                 11Mar Bar Shanghai         Northbrid,5,,13560.35,Food & Beverage,Beverages
14/03/2024,Eftpos Debit                  14Mar16:31 Brow Threads & Lashes Adelaide     Sa Au,20.22,,13565.35,Retail & Personal,Medical & Personal care
14/03/2024,Eftpos Debit                  14Mar10:16 Uber* Trip\,15.32,,13585.57,Transport & Travel,Taxi & Rental car
13/03/2024,Visa Purchase                 11Mar Cameo                Cameo.Com,109.83,,13600.89,Home & Property,Services & Tradespeople
13/03/2024,Visa Purchase                 11Mar Hwaiting Pty Ltd     Northbrid,18.03,,13710.72,Food & Beverage,Dining out
13/03/2024,Andrew Kay Manag Wages 10032024,,1464.73,13728.75,Income,Salary
13/03/2024,Eftpos Debit                  13Mar14:16 Neuronau* Trip-Bf\,8.08,,12264.02,Transport & Travel,Vehicle Expenses
13/03/2024,Eftpos Debit                  13Mar12:41 Neuronau* Trip-D7\,8.14,,12272.1,Transport & Travel,Vehicle Expenses
13/03/2024,Eftpos Debit                  13Mar10:37 Bakery On O'Connell   North Adelaidsa Au,11.41,,12280.24,Food & Beverage,Food & Groceries
13/03/2024,Eftpos Debit                  13Mar05:50 Uber* Trip\,40.67,,12291.65,Transport & Travel,Taxi & Rental car
13/03/2024,Eftpos Debit                  13Mar00:21 Uber* Trip\,38.37,,12332.32,Transport & Travel,Taxi & Rental car
12/03/2024,Visa Purchase                 09Mar Hygge Bar            Perth,35.46,,12370.69,Food & Beverage,Beverages
12/03/2024,Visa Purchase                 09Mar Hygge Bar            Perth,15.19,,12406.15,Food & Beverage,Beverages
12/03/2024,Visa Purchase                 09Mar Noodlebox Burswood   Burswood,14.95,,12421.34,Food & Beverage,Dining out
12/03/2024,Foreign Currency Conversn Fee,0.1,,12436.29,Fees & Charges,Fees & Charges
12/03/2024,Visa Purchase O/Seas          07Mar Sgd2.99 Amznprimesg Membersh,3.43,,12436.39,Retail & Personal,Retail (shopping)
12/03/2024,Eftpos Debit                  12Mar03:07 Uber* Trip\,18.1,,12439.82,Transport & Travel,Taxi & Rental car
11/03/2024,Eftpos Debit                  11Mar12:36 Uber* Trip\,19.65,,12457.92,Transport & Travel,Taxi & Rental car
11/03/2024,Eftpos Debit                  10Mar23:31 Uber* Trip\,18.04,,12477.57,Transport & Travel,Taxi & Rental car
7/03/2024,Visa Credit                   04Mar Gage Roads Freo      Fremantle,,1,12495.61,Deposits,Deposit
7/03/2024,Eftpos Debit                  07Mar20:41 Uber Eats* Eats\,25.74,,12494.61,Food & Beverage,Dining out
6/03/2024,Visa Purchase                 01Mar Anytime Deli         Burswood,10.95,,12520.35,Food & Beverage,Food & Groceries
6/03/2024,Visa Purchase                 01Mar Anytime Deli         Burswood,10.5,,12531.3,Food & Beverage,Food & Groceries
6/03/2024,Visa Purchase                 03Mar Mounts Bay Liquor    Perth,7,,12541.8,Food & Beverage,Beverages
6/03/2024,Visa Purchase                 03Mar Subway Crown         Burswood,5.7,,12548.8,Food & Beverage,Dining out
6/03/2024,Visa Purchase                 04Mar Gage Roads Freo      Fremantle,1,,12554.5,Food & Beverage,Beverages
6/03/2024,Andrew Kay Manag Wages 03032024,,1464.73,12555.5,Income,Salary
6/03/2024,Eftpos Debit                  06Mar12:46 Uber* Trip\,25.43,,11090.77,Transport & Travel,Taxi & Rental car
5/03/2024,Visa Purchase                 03Mar Noodlebox Burswood   Burswood,14.95,,11116.2,Food & Beverage,Dining out
5/03/2024,Visa Purchase                 02Mar Provender Holdings A Waterloo,2.4,,11131.15,Food & Beverage,Food & Groceries
4/03/2024,Visa Purchase                 01Mar Patreon* Membership  Internet,36.85,,11133.55,Entertainment & Recreation,TV
4/03/2024,Eftpos Debit                  04Mar16:10 Gage Roads Freo\,26.85,,11170.4,Food & Beverage,Beverages
2/03/2024,Eftpos Debit                  02Mar00:15 Kx Pilates Subiaco\,35,,11197.25,Retail & Personal,Health & Fitness
1/03/2024,Visa Purchase                 27Feb Subway Crown         Burswood,8.2,,11232.25,Food & Beverage,Dining out
1/03/2024,Eftpos Debit                  01Mar08:58 Uber* Trip\,12.5,,11240.45,Transport & Travel,Taxi & Rental car
1/03/2024,Eftpos Debit                  01Mar05:30 Uber* Trip\,18.94,,11252.95,Transport & Travel,Taxi & Rental car
29/02/2024,Visa Purchase                 26Feb Sandalford Wines     Caversham,15.25,,11271.89,Food & Beverage,Dining out
28/02/2024,Visa Purchase                 23Feb Tak Chee House       Perth,20.5,,11287.14,Food & Beverage,Dining out
28/02/2024,Visa Purchase                 23Feb Mcdonalds Crown Pert Burswood,5.45,,11307.64,Food & Beverage,Dining out
28/02/2024,Andrew Kay Manag Wages 25022024,,1464.73,11313.09,Income,Salary
27/02/2024,Visa Purchase                 24Feb Sq *Monet In Paris   Burswood,4,,9848.36,Entertainment & Recreation,Sports & Leisure
27/02/2024,Tfr Wdl BPAY Internet         27Feb05:42 440057              City Of Adelaide,571.8,,9852.36,Bills & Payments,Tax payments
26/02/2024,Visa Purchase                 23Feb Coles 0481           Perth,19.6,,10424.16,Food & Beverage,Food & Groceries
26/02/2024,Visa Purchase                 23Feb Noodlebox Burswood   Burswood,14.95,,10443.76,Food & Beverage,Dining out
26/02/2024,Eftpos Debit                  26Feb21:58 Uber* Trip\,19.41,,10458.71,Transport & Travel,Taxi & Rental car
26/02/2024,Eftpos Debit                  26Feb01:53 Uber* Trip\,16.95,,10478.12,Transport & Travel,Taxi & Rental car
26/02/2024,Eftpos Debit                  25Feb10:14 Uber Eats* Eats\,3.3,,10495.07,Food & Beverage,Dining out
26/02/2024,Eftpos Credit                 24Feb22:15 Uber Eats* Eats\,,3.3,10498.37,Deposits,Deposit
24/02/2024,Visa Purchase                 22Feb Bosu Sushii Subiaco  Subiaco,8,,10495.07,Food & Beverage,Dining out
24/02/2024,Eftpos Debit                  24Feb21:36 Uber Eats* Eats\,36.33,,10503.07,Food & Beverage,Dining out
24/02/2024,Eftpos Debit                  23Feb23:20 Uber* Trip\,16.86,,10539.4,Transport & Travel,Taxi & Rental car
23/02/2024,Eftpos Debit                  23Feb17:53 Sq *Monet In Paris    Burswood     Wa Au,8,,10556.26,Entertainment & Recreation,Sports & Leisure
23/02/2024,Eftpos Debit                  23Feb01:22 Kx Pilates Subiaco\,60,,10564.26,Retail & Personal,Health & Fitness
21/02/2024,Visa Purchase                 17Feb Mcdonalds Rndle Mall Adelaide,5.25,,10624.26,Food & Beverage,Dining out
21/02/2024,Andrew Kay Manag Wages 18022024,,1416.78,10629.51,Income,Salary
20/02/2024,Visa Purchase                 15Feb Tuno Aust Pty Ltd    North Ade,164,,9212.73,Food & Beverage,Dining out
20/02/2024,Visa Purchase                 17Feb Brow Threads & Lashe Adelaide,20.22,,9376.73,Retail & Personal,Medical & Personal care
20/02/2024,Visa Purchase                 16Feb Jurack Pty Ltd       Adelaide,20,,9396.95,Transport & Travel,Hotels and Accommodation
20/02/2024,Visa Purchase                 16Feb Bakery On O'Connell  North Ade,18.59,,9416.95,Food & Beverage,Food & Groceries
20/02/2024,Visa Purchase                 17Feb Bakery On O'Connell  North Ade,17.27,,9435.54,Food & Beverage,Food & Groceries
20/02/2024,Visa Purchase                 17Feb Amazon Marketplace A Sydney So,8.95,,9452.81,Retail & Personal,Retail (shopping)
20/02/2024,Visa Purchase                 17Feb Beam Mobility Austra -,5.22,,9461.76,Bills & Payments,Telecommunications
20/02/2024,Visa Purchase                 16Feb Southern And Western Glandore,3.5,,9466.98,Entertainment & Recreation,TV
20/02/2024,Visa Purchase                 16Feb Southern And Western Glandore,3.5,,9470.48,Entertainment & Recreation,TV
19/02/2024,Visa Purchase                 16Feb Sq *196              Adelaide,28,,9473.98,Food & Beverage,Food & Groceries
19/02/2024,Visa Purchase                 14Feb Foodworks North Adel North Ade,9.07,,9501.98,Food & Beverage,Food & Groceries
19/02/2024,Eftpos Debit                  19Feb02:22 Uber* Trip\,26.9,,9511.05,Transport & Travel,Taxi & Rental car
19/02/2024,Osko Withdrawal               18Feb18:52 Art Prints I Voigt,230,,9537.95,Withdrawals & Transfers,Withdrawal
17/02/2024,Visa Purchase                 15Feb Elysian Salon & Spa  Adelaide,453.87,,9767.95,Retail & Personal,Retail (shopping)
17/02/2024,Visa Purchase                 14Feb Costco Wholesale Aus Kilburn,223.71,,10221.82,Food & Beverage,Food & Groceries
17/02/2024,Visa Purchase                 13Feb Uber   *Trip         Sydney,66.33,,10445.53,Transport & Travel,Taxi & Rental car
17/02/2024,Visa Purchase                 15Feb Prestige Dry Clean   North Ade,22,,10511.86,Home & Property,Services & Tradespeople
17/02/2024,Visa Purchase                 15Feb Beam Mobility Austra -,7.64,,10533.86,Bills & Payments,Telecommunications
17/02/2024,Visa Purchase                 15Feb Beam Mobility Austra -,7.58,,10541.5,Bills & Payments,Telecommunications
17/02/2024,Eftpos Debit                  17Feb14:59 Neuronau* Trip-2U\,8.15,,10549.08,Transport & Travel,Vehicle Expenses
17/02/2024,Eftpos Debit                  17Feb13:13 Kx Pilates Subiaco\,60,,10557.23,Retail & Personal,Health & Fitness
17/02/2024,Eftpos Debit                  17Feb08:37 Uber* Trip\,12.63,,10617.23,Transport & Travel,Taxi & Rental car
17/02/2024,Eftpos Debit                  17Feb05:48 Uber* Trip\,15.44,,10629.86,Transport & Travel,Taxi & Rental car
16/02/2024,Visa Purchase                 14Feb Sq *Color Club       North Ade,60.6,,10645.3,Retail & Personal,Retail (shopping)
16/02/2024,Visa Purchase                 14Feb Nth Adel Foodland    North Ade,24.15,,10705.9,Food & Beverage,Food & Groceries
16/02/2024,Visa Purchase                 14Feb Fresh Point Churchil Kilburn,14.5,,10730.05,Food & Beverage,Food & Groceries
16/02/2024,Visa Purchase                 14Feb 2 Sweethearts        Kilburn N,11.67,,10744.55,Food & Beverage,Dining out
16/02/2024,Eftpos Debit                  16Feb10:08 Bakery On O'Connell   North Adelaidsa Au,11.41,,10756.22,Food & Beverage,Food & Groceries
15/02/2024,Visa Purchase                 13Feb Gn Circleoffriendsa  Summertow,51.63,,10767.63,Bills & Payments,Gifts & Donations
15/02/2024,Tfr Wdl BPAY Internet         15Feb12:02 0207782150          Sa Water,169.37,,10819.26,Bills & Payments,Utilities & Rates
15/02/2024,Eftpos Debit                  15Feb10:31 Bakery On O'Connell   North Adelaidsa Au,16.97,,10988.63,Food & Beverage,Food & Groceries
14/02/2024,Andrew Kay Manag Wages 11022024,,1464.73,11005.6,Income,Salary
14/02/2024,Internet Withdrawal           14Feb10:57 To 0280074494440,5000,,9540.87,Withdrawals & Transfers,Funds transfer
13/02/2024,Visa Purchase                 09Feb Travel Medicine Ctr  Perth,71.4,,14540.87,Retail & Personal,Medical & Personal care
13/02/2024,Visa Purchase                 10Feb Sq *Artrage          Northbrid,18,,14612.27,Entertainment & Recreation,Sports & Leisure
13/02/2024,Visa Purchase                 10Feb Sq *Artrage          Perth,15,,14630.27,Entertainment & Recreation,Sports & Leisure
13/02/2024,Visa Purchase                 10Feb Sq *Artrage          Perth,15,,14645.27,Entertainment & Recreation,Sports & Leisure
13/02/2024,Visa Purchase                 09Feb 7-Eleven 3074        Bentley,5,,14660.27,Transport & Travel,Petrol
13/02/2024,Foreign Currency Conversn Fee,0.1,,14665.27,Fees & Charges,Fees & Charges
13/02/2024,Visa Purchase O/Seas          07Feb Sgd2.99 Amznprimesg Membersh,3.43,,14665.37,Retail & Personal,Retail (shopping)
13/02/2024,Eftpos Debit                  13Feb19:25 Uber* Trip\,26.77,,14668.8,Transport & Travel,Taxi & Rental car
13/02/2024,Osko Withdrawal               13Feb16:18 Kp1302565 Bikes Only,752,,14695.57,Withdrawals & Transfers,Withdrawal
13/02/2024,Eftpos Debit                  13Feb11:46 Uber* Trip\,20.06,,15447.57,Transport & Travel,Taxi & Rental car
12/02/2024,Visa Purchase                 09Feb Kings Park Pharmacy  Perth,219.08,,15467.63,Retail & Personal,Medical & Personal care
12/02/2024,Visa Purchase                 09Feb Noodlebox Burswood   Burswood,14.95,,15686.71,Food & Beverage,Dining out
12/02/2024,Mcare Benefits 143065950 Iywq,,41.4,15701.66,Government payments,Centrelink payments
12/02/2024,Eftpos Debit                  11Feb11:01 Uber* Trip\,11.52,,15660.26,Transport & Travel,Taxi & Rental car
9/02/2024,Visa Purchase                 06Feb Fringe World         Northbrid,48.4,,15671.78,Bills & Payments,Gifts & Donations
9/02/2024,Visa Purchase                 07Feb Frankie's On Rotto   Rottnest,46.6,,15720.18,Food & Beverage,Dining out
9/02/2024,Visa Purchase                 07Feb Transit Retail Pl    Rottnest,4.5,,15766.78,Food & Beverage,Food & Groceries
8/02/2024,Visa Purchase                 05Feb Subway Crown         Burswood,5.7,,15771.28,Food & Beverage,Dining out
8/02/2024,Eftpos Debit                  07Feb22:25 Uber* Trip\,14.27,,15776.98,Transport & Travel,Taxi & Rental car
7/02/2024,Visa Purchase                 03Feb Perth Theatre Trust  Perth,17,,15791.25,Entertainment & Recreation,TV
7/02/2024,Andrew Kay Manag Wages 04022024,,1464.73,15808.25,Income,Salary
6/02/2024,Visa Purchase                 02Feb Rottnest Express     Adelaide,278.4,,14343.52,Transport & Travel,Holidays
6/02/2024,Visa Purchase                 04Feb Woolworths Online    Bella Vis,92.7,,14621.92,Food & Beverage,Food & Groceries
6/02/2024,Visa Purchase                 02Feb Travel Medicine Ctr  Perth,71.4,,14714.62,Retail & Personal,Medical & Personal care
6/02/2024,Visa Purchase                 04Feb Alh Venues/King & Mu Perth,44.9,,14786.02,Transport & Travel,Hotels and Accommodation
6/02/2024,Visa Purchase                 02Feb Triangle Auto Care P East Vict,30,,14830.92,Transport & Travel,Vehicle Expenses
6/02/2024,Visa Purchase                 02Feb Joymall Grocery      East Vict,22.98,,14860.92,Food & Beverage,Food & Groceries
6/02/2024,Visa Purchase                 04Feb Www.Alhgroup.Com* Me Sydney,12.87,,14883.9,Bills & Payments,Expenses & Payments
5/02/2024,Visa Purchase                 01Feb Subway Crown         Burswood,5.7,,14896.77,Food & Beverage,Dining out
5/02/2024,Visa Purchase                 31Jan Perth Theatre Trust  Perth,4,,14902.47,Entertainment & Recreation,TV
3/02/2024,Visa Purchase                 01Feb Patreon* Membership  Internet,36.85,,14906.47,Entertainment & Recreation,TV
3/02/2024,Visa Purchase                 31Jan Thuy Nguyen          Perth,25,,14943.32,Retail & Personal,Retail (shopping)
3/02/2024,Visa Purchase                 31Jan Kuld Creamery        Northbrid,14,,14968.32,Food & Beverage,Dining out
3/02/2024,Visa Purchase                 31Jan Voyage Kitchen       City Beac,4,,14982.32,Food & Beverage,Dining out
2/02/2024,Mcare Benefits 747149312 Iywq,,41.4,14986.32,Government payments,Centrelink payments
1/02/2024,Visa Purchase                 30Jan Amj Linn P/L&Ds&Jn   North Ade,90,,14944.92,Retail & Personal,Medical & Personal care
1/02/2024,Visa Purchase                 30Jan Be Loved Alteration  Subiaco,30,,15034.92,Retail & Personal,Clothing & Shoes
1/02/2024,Visa Purchase                 30Jan Noodlebox Burswood   Burswood,13.45,,15064.92,Food & Beverage,Dining out
31/01/2024,Visa Purchase                 28Jan Brisbane Hotel Holdi Highgate,26.12,,15078.37,Food & Beverage,Beverages
31/01/2024,Andrew Kay Manag Wages 28012024,,1464.73,15104.49,Income,Salary
30/01/2024,Visa Purchase                 26Jan Izakaya Grill        Northbrid,149,,13639.76,Food & Beverage,Dining out
30/01/2024,Visa Purchase                 27Jan Sq *Con Pebre        Perth,19.28,,13788.76,Food & Beverage,Dining out
30/01/2024,Mcare Benefits 744176846 Gywq,,41.4,13808.04,Government payments,Centrelink payments
30/01/2024,Eftpos Debit                  29Jan23:18 Uber* Trip\,11.12,,13766.64,Transport & Travel,Taxi & Rental car
29/01/2024,Visa Purchase                 27Jan Momenthouse.Com      Momenthou,30.72,,13777.76,Entertainment & Recreation,Sports & Leisure
29/01/2024,Visa Purchase                 26Jan Alh Venues/James & W Northbrid,28,,13808.48,Transport & Travel,Hotels and Accommodation
29/01/2024,Visa Purchase                 24Jan Fitch's Chemists     Perth,19.95,,13836.48,Retail & Personal,Medical & Personal care
29/01/2024,Visa Purchase                 26Jan Sq *Monet In Paris   Burswood,13,,13856.43,Entertainment & Recreation,Sports & Leisure
29/01/2024,Visa Purchase                 24Jan A Cuppa Coffee House Perth,6.58,,13869.43,Food & Beverage,Beverages
29/01/2024,Eftpos Debit                  29Jan09:51 Uber* Trip\,12.91,,13876.01,Transport & Travel,Taxi & Rental car
29/01/2024,Eftpos Debit                  29Jan07:27 Uber* Trip\,14.1,,13888.92,Transport & Travel,Taxi & Rental car
29/01/2024,Eftpos Debit                  28Jan08:48 Uber* Trip\,17.4,,13903.02,Transport & Travel,Taxi & Rental car
27/01/2024,Visa Purchase                 23Jan Viva Nails           Subiaco,45,,13920.42,Retail & Personal,Retail (shopping)
25/01/2024,Visa Purchase                 23Jan Strip Womens Wc      Subiaco,65,,13965.42,Retail & Personal,Retail (shopping)
25/01/2024,Visa Purchase                 23Jan Bun Mi Subiaco       Subiaco,14.5,,14030.42,Food & Beverage,Dining out
24/01/2024,Visa Purchase                 21Jan 399 Bar              Perth,8,,14044.92,Food & Beverage,Beverages
24/01/2024,Visa Purchase                 21Jan 399 Bar              Perth,8,,14052.92,Food & Beverage,Beverages
24/01/2024,Visa Purchase                 21Jan Kuld Creamery        Northbrid,7,,14060.92,Food & Beverage,Dining out
24/01/2024,Andrew Kay Manag Wages 21012024,,1464.73,14067.92,Income,Salary
23/01/2024,Visa Purchase                 19Jan Sq *Double Rainbow E Perth,47,,12603.19,Food & Beverage,Dining out
23/01/2024,Visa Purchase                 20Jan Fenway Subiaco       Subiaco,29.72,,12650.19,Food & Beverage,Beverages
23/01/2024,Visa Purchase                 19Jan Sq *Double Rainbow E Perth,28,,12679.91,Food & Beverage,Dining out
23/01/2024,Visa Purchase                 20Jan Fenway Subiaco       Subiaco,12.64,,12707.91,Food & Beverage,Beverages
22/01/2024,Visa Purchase                 18Jan Foodies Market Langl East Pert,15.56,,12720.55,Food & Beverage,Food & Groceries
22/01/2024,Eftpos Debit                  21Jan09:42 Uber* Trip\,15.14,,12736.11,Transport & Travel,Taxi & Rental car
22/01/2024,Eftpos Debit                  21Jan08:05 Uber* Trip\,12.41,,12751.25,Transport & Travel,Taxi & Rental car
20/01/2024,Visa Purchase                 16Jan Coles Online         Hawthorn,130.05,,12763.66,Food & Beverage,Food & Groceries
20/01/2024,Visa Purchase                 17Jan Sharky S             Mandurah,44.5,,12893.71,Food & Beverage,Dining out
20/01/2024,Visa Purchase                 16Jan Optus Stadium        Burswood,24.6,,12938.21,Bills & Payments,Telecommunications
20/01/2024,Visa Purchase                 18Jan Noodlebox Burswood   Burswood,13.95,,12962.81,Food & Beverage,Dining out
20/01/2024,Visa Purchase                 16Jan Optus Stadium        Burswood,10.9,,12976.76,Bills & Payments,Telecommunications
20/01/2024,Eftpos Debit                  20Jan01:58 Uber* Trip\,16.12,,12987.66,Transport & Travel,Taxi & Rental car
19/01/2024,Visa Purchase                 17Jan Au Theraphy Pty Ltd  Perth,90,,13003.78,Retail & Personal,Medical & Personal care
18/01/2024,Osko Withdrawal               18Jan19:07 Fifo Ineka Voigt I Voigt,25,,13093.78,Withdrawals & Transfers,Withdrawal
17/01/2024,Visa Purchase                 14Jan Fringe World         Northbrid,75.8,,13118.78,Bills & Payments,Gifts & Donations
17/01/2024,Andrew Kay Manag Wages 14012024,,1464.73,13194.58,Income,Salary
16/01/2024,Visa Purchase                 13Jan Gn Circleoffriendsa  Summertow,51.63,,11729.85,Bills & Payments,Gifts & Donations
16/01/2024,Visa Purchase                 12Jan Subway Crown         Burswood,15.2,,11781.48,Food & Beverage,Dining out
15/01/2024,Visa Purchase                 11Jan Mcdonalds Crown Pert Burswood,5.45,,11796.68,Food & Beverage,Dining out
13/01/2024,Visa Purchase                 11Jan Noodlebox Burswood   Burswood,14.95,,11802.13,Food & Beverage,Dining out
12/01/2024,Visa Purchase                 09Jan Hygge Bar            Perth,35.46,,11817.08,Food & Beverage,Beverages
12/01/2024,Visa Purchase                 09Jan Hygge Bar            Perth,20.26,,11852.54,Food & Beverage,Beverages
12/01/2024,Visa Purchase                 09Jan Hygge Bar            Perth,15.19,,11872.8,Food & Beverage,Beverages
12/01/2024,Visa Purchase                 10Jan Gin Sushiya Pty Ltd  Perth,13.75,,11887.99,Food & Beverage,Dining out
12/01/2024,Visa Purchase                 10Jan Brew - Ha The Ritual Subiaco,12.2,,11901.74,Food & Beverage,Dining out
11/01/2024,Foreign Currency Conversn Fee,0.1,,11913.94,Fees & Charges,Fees & Charges
11/01/2024,Visa Purchase O/Seas          07Jan Sgd2.99 2C2*Amznprimesg Memb,3.38,,11914.04,Retail & Personal,Retail (shopping)
10/01/2024,Visa Purchase                 06Jan Aldi Stores - Butler Butler,0.99,,11917.42,Food & Beverage,Food & Groceries
10/01/2024,Andrew Kay Manag Wages 07012024,,1464.73,11918.41,Income,Salary
9/01/2024,Visa Purchase                 06Jan Smp*Hermanos En Taco Leedervil,44.88,,10453.68,Food & Beverage,Dining out
9/01/2024,Visa Purchase                 06Jan Leed Comm Pharmacy   Leedervil,14.95,,10498.56,Retail & Personal,Medical & Personal care
8/01/2024,Eftpos Debit                  07Jan05:31 Uber* Trip\,13.86,,10513.51,Transport & Travel,Taxi & Rental car
4/01/2024,Visa Purchase                 02Jan Origin Energy Ltd    Barangaro,455.98,,10527.37,Bills & Payments,Utilities & Rates
4/01/2024,Visa Purchase                 01Jan Gusto (Wa) Pty Ltd   Perth,5.9,,10983.35,Food & Beverage,Dining out
3/01/2024,Visa Purchase                 01Jan The Lucky Shag       Perth,41.5,,10989.25,Food & Beverage,Beverages
3/01/2024,Visa Purchase                 01Jan Patreon* Membership  Internet,36.85,,11030.75,Entertainment & Recreation,TV
3/01/2024,Visa Purchase                 30Dec Pharm777Rokebyrd     Subiaco,21.95,,11067.6,Retail & Personal,Medical & Personal care
3/01/2024,Visa Purchase                 30Dec Noodlebox Burswood   Burswood,12.55,,11089.55,Food & Beverage,Dining out
3/01/2024,Andrew Kay Manag Wages 31122023,,1464.73,11102.1,Income,Salary
2/01/2024,Visa Purchase                 28Dec Victoria Park Discou Victoria,42.37,,9637.37,Retail & Personal,Medical & Personal care
2/01/2024,Visa Purchase                 28Dec Vic Park Fruit & Veg Victoria,8.99,,9679.74,Food & Beverage,Food & Groceries
2/01/2024,Visa Purchase                 28Dec Vic Park Fruit & Veg Victoria,7.41,,9688.73,Food & Beverage,Food & Groceries
2/01/2024,Eftpos Debit                  01Jan08:14 Uber* Trip\,18.5,,9696.14,Transport & Travel,Taxi & Rental car
30/12/2023,Visa Purchase                 27Dec Csk 7 Pty Ltd        Perth,10.9,,9714.64,Food & Beverage,Dining out
30/12/2023,Visa Purchase                 27Dec Amcal Pharmacity     Perth,3.99,,9725.54,Retail & Personal,Medical & Personal care
29/12/2023,Visa Purchase                 25Dec Kings Park Kiosk     Kings Par,7.12,,9729.53,Food & Beverage,Dining out
29/12/2023,Visa Purchase                 23Dec Mcdonalds Crown Pert Burswood,5.45,,9736.65,Food & Beverage,Dining out
28/12/2023,Visa Purchase                 23Dec Woolworths Online    Bella Vis,72.5,,9742.1,Food & Beverage,Food & Groceries
28/12/2023,Visa Purchase                 24Dec Sq *Artrage Inc.     Northbrid,39,,9814.6,Entertainment & Recreation,Sports & Leisure
28/12/2023,Visa Purchase                 24Dec Hoodburger Northbrid Northbrid,19,,9853.6,Food & Beverage,Dining out
28/12/2023,Visa Purchase                 23Dec Noodlebox Burswood   Burswood,17.9,,9872.6,Food & Beverage,Dining out
28/12/2023,Visa Purchase                 24Dec Sq *Artrage Inc.     Northbrid,11,,9890.5,Entertainment & Recreation,Sports & Leisure
28/12/2023,Visa Purchase                 24Dec Caltex Burswood      Burswood,4.5,,9901.5,Transport & Travel,Petrol
27/12/2023,Deft Payments Deft      21303050,942.99,,9906,Bills & Payments,Expenses & Payments
27/12/2023,Visa Purchase                 22Dec Sq *Monet In Paris   Burswood,8.5,,10848.99,Entertainment & Recreation,Sports & Leisure
27/12/2023,Andrew Kay Manag Wages 24122023,,1464.73,10857.49,Income,Salary
27/12/2023,Eftpos Debit                  25Dec02:47 Uber* Trip\,15.61,,9392.76,Transport & Travel,Taxi & Rental car
23/12/2023,Visa Purchase                 21Dec Kx Pilates Subiaco   Subiaco,310,,9408.37,Retail & Personal,Health & Fitness
23/12/2023,Visa Purchase                 20Dec Gn Circleoffriendsa  Summertow,103.25,,9718.37,Bills & Payments,Gifts & Donations
23/12/2023,Visa Purchase                 19Dec Cicerello 's (Freman Fremantle,16,,9821.62,Food & Beverage,Dining out
23/12/2023,Visa Purchase                 20Dec Subway Crown         Burswood,13.7,,9837.62,Food & Beverage,Dining out
23/12/2023,Eftpos Debit                  23Dec11:28 Kailis Bros Fish Mkt  Leederville  Wa Au,30.84,,9851.32,Food & Beverage,Food & Groceries
22/12/2023,Visa Purchase                 19Dec Djurra               Fremantle,67,,9882.16,Retail & Personal,Retail (shopping)
22/12/2023,Visa Purchase                 19Dec Cicerello 's (Freman Fremantle,31.5,,9949.16,Food & Beverage,Dining out
22/12/2023,Visa Purchase                 19Dec Kakulas Sister Groce Fremantle,20.35,,9980.66,Food & Beverage,Food & Groceries
22/12/2023,Visa Purchase                 19Dec The Whistle Stop     Fremantle,13.5,,10001.01,Retail & Personal,Retail (shopping)
22/12/2023,Visa Purchase                 19Dec Cicerello 's (Freman Fremantle,13.2,,10014.51,Food & Beverage,Dining out
22/12/2023,Osko Withdrawal               22Dec16:36 Iv00000001422 210 Gover St Door Jvl Pain,748,,10027.71,Withdrawals & Transfers,Withdrawal
21/12/2023,Visa Purchase                 19Dec Kartique Trading     Fremantle,105,,10775.71,Home & Property,Furnishings
21/12/2023,Visa Purchase                 19Dec Get Chunky Fremantle Fremantle,45,,10880.71,Food & Beverage,Food & Groceries
21/12/2023,Tfr Wdl BPAY Internet         21Dec13:11 500015101776        Origin Energy,170.87,,10925.71,Bills & Payments,Utilities & Rates
20/12/2023,Visa Purchase                 17Dec Wellington Hotel     North Ade,50,,11096.58,Food & Beverage,Beverages
20/12/2023,Visa Purchase                 17Dec Wellington Hotel     North Ade,21.9,,11146.58,Food & Beverage,Beverages
20/12/2023,Andrew Kay Manag Wages 17122023,,1464.73,11168.48,Income,Salary
19/12/2023,Visa Purchase                 15Dec Targett Medical Pty  North Ade,1155,,9703.75,Retail & Personal,Retail (shopping)
19/12/2023,Visa Purchase                 16Dec Adelaide Fringe Inc  Adelaide,98.8,,10858.75,Entertainment & Recreation,Sports & Leisure
19/12/2023,Visa Purchase                 15Dec Bakery On O'Connell  North Ade,12.12,,10957.55,Food & Beverage,Food & Groceries
18/12/2023,Visa Purchase                 15Dec Sq *Asia Oasis       Salisbury,30,,10969.67,Entertainment & Recreation,Catering
18/12/2023,Visa Purchase                 15Dec The Coffee Bean Shop Welland,27.5,,10999.67,Food & Beverage,Beverages
18/12/2023,Visa Purchase                 15Dec Sq *Asia Oasis       Salisbury,24,,11027.17,Entertainment & Recreation,Catering
18/12/2023,Visa Purchase                 15Dec Beam Mobility Austra -,11.4,,11051.17,Bills & Payments,Telecommunications
18/12/2023,Visa Purchase                 15Dec Beam Mobility Austra -,7.65,,11062.57,Bills & Payments,Telecommunications
18/12/2023,Osko Withdrawal               18Dec19:06 Cus18979139 Kelly Payfer Koala Bin Wash,198,,11070.22,Withdrawals & Transfers,Withdrawal
18/12/2023,Eftpos Debit                  18Dec09:43 Uber* Trip\,44.21,,11268.22,Transport & Travel,Taxi & Rental car
18/12/2023,Eftpos Debit                  17Dec22:53 Uber* Trip\,28.57,,11312.43,Transport & Travel,Taxi & Rental car
16/12/2023,Eftpos Debit                  16Dec17:16 Uber* Trip\,48.08,,11341,Transport & Travel,Taxi & Rental car
16/12/2023,Eftpos Debit                  16Dec10:20 Bakery On O'Connell   North Adelaidsa Au,22.32,,11389.08,Food & Beverage,Food & Groceries
16/12/2023,Eftpos Debit                  15Dec22:12 Neuronau* Trip-Vh\,6.11,,11411.4,Transport & Travel,Vehicle Expenses
15/12/2023,Eftpos Debit                  15Dec15:48 Sq *Color Club        North Adelaidsa Au,25.25,,11417.51,Retail & Personal,Retail (shopping)
15/12/2023,Atm Withdrawal -Wbc           15Dec13:35 Westpac               Adelaide     5  Au,400,,11442.76,Withdrawals & Transfers,ATM & EFTPOS
15/12/2023,Eftpos Debit                  15Dec12:12 Neuronau* Trip-Mv\,7.12,,11842.76,Transport & Travel,Vehicle Expenses
15/12/2023,Eftpos Debit                  15Dec10:27 Uber* Trip\,36.44,,11849.88,Transport & Travel,Taxi & Rental car
15/12/2023,Eftpos Debit                  15Dec09:42 Bakery On O'Connell   North Adelaidsa Au,16.77,,11886.32,Food & Beverage,Food & Groceries
15/12/2023,Eftpos Debit                  15Dec04:48 Uber* Trip\,28.25,,11903.09,Transport & Travel,Taxi & Rental car
14/12/2023,Eftpos Debit                  14Dec22:03 Uber* Trip\,17.55,,11931.34,Transport & Travel,Taxi & Rental car
14/12/2023,Osko Withdrawal               14Dec12:44 Kelli O'Rielly,325,,11948.89,Withdrawals & Transfers,Withdrawal
13/12/2023,Visa Purchase                 11Dec L'Occitane Australia Perth,135,,12273.89,Retail & Personal,Retail (shopping)
13/12/2023,Visa Purchase                 08Dec Anytime Deli         Burswood,9.05,,12408.89,Food & Beverage,Food & Groceries
13/12/2023,Andrew Kay Manag Wages 10122023,,1464.73,12417.94,Income,Salary
12/12/2023,Foreign Currency Conversn Fee,0.1,,10953.21,Fees & Charges,Fees & Charges
12/12/2023,Visa Purchase O/Seas          07Dec Sgd2.99 2C2*Amznprimesg Memb,3.41,,10953.31,Retail & Personal,Retail (shopping)
12/12/2023,Eftpos Debit                  12Dec10:12 Uber* Trip\,17.64,,10956.72,Transport & Travel,Taxi & Rental car
12/12/2023,Eftpos Debit                  12Dec04:40 Uber* Trip\,17.1,,10974.36,Transport & Travel,Taxi & Rental car
11/12/2023,Visa Purchase                 07Dec Astor Theatre Perth  Mount Law,18.19,,10991.46,Entertainment & Recreation,TV
11/12/2023,Visa Purchase                 07Dec Astor Theatre Perth  Mount Law,17.18,,11009.65,Entertainment & Recreation,TV
11/12/2023,Visa Purchase                 07Dec Mcdonalds Crown Pert Burswood,5.45,,11026.83,Food & Beverage,Dining out
11/12/2023,Visa Purchase                 07Dec Subway Crown         Burswood,3.5,,11032.28,Food & Beverage,Dining out
11/12/2023,Atm Withdrawal -Wbc           11Dec13:39 Westpac               Perth        6  Au,500,,11035.78,Withdrawals & Transfers,ATM & EFTPOS
9/12/2023,Visa Purchase                 06Dec B Store              Claremont,146,,11535.78,Retail & Personal,Clothing & Shoes
9/12/2023,Visa Purchase                 07Dec Spotlight Melville   Myaree,80.9,,11681.78,Home & Property,Furnishings
9/12/2023,Visa Purchase                 06Dec Pigeonhole Perth 2   Perth,59.9,,11762.68,Bills & Payments,Gifts & Donations
9/12/2023,Visa Purchase                 06Dec Thuy Nguyen          Perth,55,,11822.58,Retail & Personal,Retail (shopping)
9/12/2023,Visa Purchase                 06Dec Smp*Mica Creamery Lo Perth,5.59,,11877.58,Food & Beverage,Dining out
8/12/2023,Visa Purchase                 06Dec Alh Venues/James & W Northbrid,26,,11883.17,Transport & Travel,Hotels and Accommodation
8/12/2023,Visa Purchase                 06Dec Sq *Neighbourhood Ba Perth,23,,11909.17,Food & Beverage,Food & Groceries
8/12/2023,Visa Purchase                 05Dec Spotlight Pty Ltd    Sth Melbo,14,,11932.17,Home & Property,Furnishings
8/12/2023,Eftpos Debit                  08Dec07:39 Uber* Trip\,18.51,,11946.17,Transport & Travel,Taxi & Rental car
7/12/2023,Visa Purchase                 05Dec Provender Holdings A Waterloo,2.9,,11964.68,Food & Beverage,Food & Groceries
6/12/2023,Andrew Kay Manag Wages 03122023,,1464.73,11967.58,Income,Salary
5/12/2023,Visa Purchase                 01Dec Bentley Teamind Pty  Bentley,54.6,,10502.85,Food & Beverage,Dining out
5/12/2023,Visa Purchase                 01Dec A Cuppa Coffee House Perth,11.13,,10557.45,Food & Beverage,Beverages
5/12/2023,Visa Purchase                 01Dec Provender Holdings A Waterloo,2.9,,10568.58,Food & Beverage,Food & Groceries
4/12/2023,Visa Purchase                 01Dec L'Occitane Australia Perth,111.2,,10571.48,Retail & Personal,Retail (shopping)
4/12/2023,Visa Purchase                 01Dec Subiaco Hotel        Subiaco,60.6,,10682.68,Food & Beverage,Beverages
4/12/2023,Visa Purchase                 01Dec Patreon* Membership  Internet,36.85,,10743.28,Entertainment & Recreation,TV
4/12/2023,Visa Purchase                 01Dec Subiaco Hotel        Subiaco,27.78,,10780.13,Food & Beverage,Beverages
4/12/2023,Visa Purchase                 01Dec Officeworks 0615     Perth,8.7,,10807.91,Retail & Personal,Retail (shopping)
4/12/2023,Visa Purchase                 01Dec Kmart 1386           Perth,5,,10816.61,Retail & Personal,Retail (shopping)
2/12/2023,Visa Purchase                 29Nov Provender Holdings A Waterloo,2.7,,10821.61,Food & Beverage,Food & Groceries
2/12/2023,Eftpos Debit                  02Dec03:36 Uber* Trip\,17.97,,10824.31,Transport & Travel,Taxi & Rental car
2/12/2023,Eftpos Debit                  02Dec02:59 Uber* Trip\,14.22,,10842.28,Transport & Travel,Taxi & Rental car
2/12/2023,Eftpos Debit                  02Dec01:27 Uber* Trip\,13.62,,10856.5,Transport & Travel,Taxi & Rental car
2/12/2023,Eftpos Debit                  02Dec00:09 Sq *Nikola Estate And Middle Swan  Wa Au,22.25,,10870.12,Entertainment & Recreation,Sports & Leisure
1/12/2023,Visa Purchase                 29Nov Hifumiya             Perth,51.86,,10892.37,Food & Beverage,Dining out
1/12/2023,Visa Purchase                 28Nov Anytime Deli         Burswood,17.5,,10944.23,Food & Beverage,Food & Groceries
1/12/2023,Internet Withdrawal           01Dec15:33 To 0280074494440,4000,,10961.73,Withdrawals & Transfers,Funds transfer
30/11/2023,Visa Purchase                 26Nov Izakaya Grill        Northbrid,149.21,,14961.73,Food & Beverage,Dining out
30/11/2023,Visa Purchase                 27Nov Shanghai St Northbri Northbrid,66.69,,15110.94,Food & Beverage,Dining out
30/11/2023,Visa Purchase                 27Nov Anytime Deli         Burswood,11.1,,15177.63,Food & Beverage,Food & Groceries
29/11/2023,Visa Purchase                 26Nov Sq *Cheeky Waffles P Northbrid,12.19,,15188.73,Food & Beverage,Food & Groceries
29/11/2023,Andrew Kay Manag Wages 26112023,,1464.73,15200.92,Income,Salary
29/11/2023,Eftpos Debit                  29Nov12:45 Uber* Trip\,18.33,,13736.19,Transport & Travel,Taxi & Rental car
29/11/2023,Eftpos Debit                  29Nov07:53 Uber* Trip\,21.4,,13754.52,Transport & Travel,Taxi & Rental car
29/11/2023,Tfr Wdl BPAY Internet         29Nov05:49 440057              City Of Adelaide,571.8,,13775.92,Bills & Payments,Tax payments
28/11/2023,Visa Purchase                 25Nov Fenway Subiaco       Subiaco,71.07,,14347.72,Food & Beverage,Beverages
28/11/2023,Visa Purchase                 25Nov Subiaco Hotel        Subiaco,27.78,,14418.79,Food & Beverage,Beverages
28/11/2023,Visa Purchase                 25Nov Subiaco Hotel        Subiaco,25.25,,14446.57,Food & Beverage,Beverages
28/11/2023,Visa Purchase                 25Nov Fenway Subiaco       Subiaco,22.24,,14471.82,Food & Beverage,Beverages
28/11/2023,Visa Purchase                 25Nov Fenway Subiaco       Subiaco,19.71,,14494.06,Food & Beverage,Beverages
28/11/2023,Visa Purchase                 25Nov Fenway Subiaco       Subiaco,12.64,,14513.77,Food & Beverage,Beverages
28/11/2023,Mcare Benefits 703183874 Iywq,,41.4,14526.41,Government payments,Centrelink payments
28/11/2023,Eftpos Debit                  28Nov08:12 Uber* Trip\,10.83,,14485.01,Transport & Travel,Taxi & Rental car
27/11/2023,Eftpos Debit                  27Nov10:44 Uber* Trip\,11.75,,14495.84,Transport & Travel,Taxi & Rental car
27/11/2023,Eftpos Debit                  27Nov08:00 Uber* Trip\,10.66,,14507.59,Transport & Travel,Taxi & Rental car
27/11/2023,Eftpos Debit                  26Nov12:02 Uber* Trip\,15.17,,14518.25,Transport & Travel,Taxi & Rental car
27/11/2023,Eftpos Debit                  26Nov06:36 Uber* Trip\,12.63,,14533.42,Transport & Travel,Taxi & Rental car
25/11/2023,Visa Purchase                 23Nov Kx Pilates Subiaco   Subiaco,102,,14546.05,Retail & Personal,Health & Fitness
24/11/2023,Mcare Benefits 701145683 Iywq,,41.4,14648.05,Government payments,Centrelink payments
24/11/2023,Eftpos Debit                  24Nov03:12 Uber* Trip\,17.84,,14606.65,Transport & Travel,Taxi & Rental car
23/11/2023,Visa Purchase                 20Nov Coles Online         Hawthorn,50.1,,14624.49,Food & Beverage,Food & Groceries
22/11/2023,Andrew Kay Manag Wages 19112023,,1464.73,14674.59,Income,Salary
20/11/2023,Visa Purchase                 17Nov Kx Pilates Subiaco   Subiaco,60,,13209.86,Retail & Personal,Health & Fitness
20/11/2023,Visa Purchase                 17Nov Neuronau* Temphold-P Hawthorn,4.57,,13269.86,Transport & Travel,Vehicle Expenses
17/11/2023,Visa Purchase                 15Nov Provender Holdings A Waterloo,2.9,,13274.43,Food & Beverage,Food & Groceries
16/11/2023,Visa Purchase                 13Nov Vic Park Fruit & Veg Victoria,15.96,,13277.33,Food & Beverage,Food & Groceries
16/11/2023,Visa Purchase                 14Nov Sq *Neighbourhood Ba Perth,8,,13293.29,Food & Beverage,Food & Groceries
16/11/2023,Visa Purchase                 13Nov Wings Enterprises Wa Victoria,4.2,,13301.29,Food & Beverage,Food & Groceries
16/11/2023,Eftpos Debit                  16Nov11:43 Uber* Trip\,22.88,,13305.49,Transport & Travel,Taxi & Rental car
16/11/2023,Eftpos Debit                  16Nov00:20 Uber* Trip\,17.41,,13328.37,Transport & Travel,Taxi & Rental car
15/11/2023,Visa Purchase                 12Nov Luna Cinemas         Leedervil,21.5,,13345.78,Entertainment & Recreation,TV
15/11/2023,Visa Purchase                 12Nov Luna Cinemas         Leedervil,17,,13367.28,Entertainment & Recreation,TV
15/11/2023,Andrew Kay Manag Wages 12112023,,1534.88,13384.28,Income,Salary
15/11/2023,Eftpos Debit                  15Nov13:18 Uber* Trip\,17.43,,11849.4,Transport & Travel,Taxi & Rental car
15/11/2023,Eftpos Debit                  15Nov05:40 Uber* Trip\,19.23,,11866.83,Transport & Travel,Taxi & Rental car
14/11/2023,Visa Purchase                 12Nov Woolworths Online    Bella Vis,90.9,,11886.06,Food & Beverage,Food & Groceries
14/11/2023,Visa Purchase                 11Nov S And Y Family Trust Subiaco,90,,11976.96,Retail & Personal,Medical & Personal care
14/11/2023,Visa Purchase                 10Nov Hifumiya             Perth,57.63,,12066.96,Food & Beverage,Dining out
14/11/2023,Visa Purchase                 11Nov Bws Liquor/Subiaco S Subiaco,26,,12124.59,Food & Beverage,Beverages
14/11/2023,Visa Purchase                 10Nov Subway Crown         Burswood,20.3,,12150.59,Food & Beverage,Dining out
14/11/2023,Visa Purchase                 12Nov The Garden           Leedervil,20.12,,12170.89,Food & Beverage,Beverages
14/11/2023,Visa Purchase                 11Nov Noodlebox Burswood   Burswood,14.35,,12191.01,Food & Beverage,Dining out
14/11/2023,Visa Purchase                 10Nov Xchange Convenience  Perth,2.5,,12205.36,Food & Beverage,Food & Groceries
14/11/2023,Ecp Events Contractor Payment,,35.6,12207.86,Deposits,Deposit
11/11/2023,Foreign Currency Conversn Fee,0.1,,12172.26,Fees & Charges,Fees & Charges
11/11/2023,Visa Purchase O/Seas          07Nov Sgd2.99 2C2*Amznprimesg Memb,3.41,,12172.36,Retail & Personal,Retail (shopping)
10/11/2023,Visa Purchase                 08Nov Noodlebox Burswood   Burswood,16.95,,12175.77,Food & Beverage,Dining out
9/11/2023,Visa Purchase                 05Nov Royal Copenhagen Por Port Noar,20,,12192.72,Food & Beverage,Food & Groceries
9/11/2023,Ecp Events Contractor Payment,,225.47,12212.72,Deposits,Deposit
8/11/2023,Visa Purchase                 06Nov Fenway Subiaco       Subiaco,22.14,,11987.25,Food & Beverage,Beverages
8/11/2023,Visa Purchase                 06Nov Fenway Subiaco       Subiaco,10.62,,12009.39,Food & Beverage,Beverages
8/11/2023,Visa Purchase                 06Nov Fenway Subiaco       Subiaco,9.1,,12020.01,Food & Beverage,Beverages
8/11/2023,Andrew Kay Manag Wages 05112023,,671,12029.11,Income,Salary
7/11/2023,Visa Purchase                 03Nov Governor Hindmarsh H Hindmarsh,38.5,,11358.11,Food & Beverage,Beverages
7/11/2023,Visa Purchase                 03Nov Governor Hindmarsh H Hindmarsh,16.5,,11396.61,Food & Beverage,Beverages
7/11/2023,Eftpos Debit                  07Nov21:45 Uber* Trip\,16.86,,11413.11,Transport & Travel,Taxi & Rental car
7/11/2023,Eftpos Debit                  07Nov08:54 Uber* Trip\,12.89,,11429.97,Transport & Travel,Taxi & Rental car
7/11/2023,Eftpos Debit                  06Nov22:47 Uber* Trip\,25.64,,11442.86,Transport & Travel,Taxi & Rental car
6/11/2023,Visa Purchase                 03Nov Prestige Dry Clean   North Ade,107,,11468.5,Home & Property,Services & Tradespeople
6/11/2023,Visa Purchase                 03Nov Krung Thep           North Ade,87,,11575.5,Food & Beverage,Dining out
6/11/2023,Visa Purchase                 03Nov Prestige Dry Clean   North Ade,76,,11662.5,Home & Property,Services & Tradespeople
6/11/2023,Visa Purchase                 02Nov Bakery On O'Connell  North Ade,16.67,,11738.5,Food & Beverage,Food & Groceries
6/11/2023,Visa Purchase                 02Nov Tafe Sa Regency Camp Regency P,5.7,,11755.17,Retail & Personal,Education & Training
6/11/2023,Eftpos Debit                  06Nov22:04 Uber* Trip\,49.51,,11760.87,Transport & Travel,Taxi & Rental car
6/11/2023,Eftpos Debit                  06Nov09:32 Bakery On O'Connell   North Adelaidsa Au,30.61,,11810.38,Food & Beverage,Food & Groceries
6/11/2023,Eftpos Debit                  06Nov07:53 Uber Eats* Eats\,2.42,,11840.99,Food & Beverage,Dining out
6/11/2023,Eftpos Credit                 05Nov19:54 Uber Eats* Eats\,,2.42,11843.41,Deposits,Deposit
6/11/2023,Eftpos Debit                  05Nov19:30 Uber Eats* Eats\,46.82,,11840.99,Food & Beverage,Dining out
4/11/2023,Eftpos Debit                  04Nov11:27 Uber* Trip\,11.56,,11887.81,Transport & Travel,Taxi & Rental car
4/11/2023,Eftpos Debit                  04Nov08:09 Uber* Trip\,12.63,,11899.37,Transport & Travel,Taxi & Rental car
3/11/2023,Visa Purchase                 01Nov Elysian Salon & Spa  Adelaide,430,,11912,Retail & Personal,Retail (shopping)
3/11/2023,Visa Purchase                 01Nov Amj Linn P/L&Ds&Jn   North Ade,88,,12342,Retail & Personal,Medical & Personal care
3/11/2023,Visa Purchase                 01Nov Patreon* Membership  Internet,36.85,,12430,Entertainment & Recreation,TV
3/11/2023,Visa Purchase                 01Nov Beam Mobility Austra -,8.8,,12466.85,Bills & Payments,Telecommunications
3/11/2023,Eftpos Debit                  03Nov14:06 Sq *Color Club        North Adelaidsa Au,24.24,,12475.65,Retail & Personal,Retail (shopping)
3/11/2023,Eftpos Debit                  03Nov09:30 Bakery On O'Connell   North Adelaidsa Au,5.35,,12499.89,Food & Beverage,Food & Groceries
2/11/2023,Visa Purchase                 31Oct Nth Adel Foodland    North Ade,20.38,,12505.24,Food & Beverage,Food & Groceries
1/11/2023,Visa Purchase                 30Oct Sq *Color Club       North Ade,48.48,,12525.62,Retail & Personal,Retail (shopping)
1/11/2023,Visa Purchase                 29Oct Piccadilly Cinemas   North Ade,21.5,,12574.1,Entertainment & Recreation,TV
1/11/2023,Visa Purchase                 29Oct Beam Mobility Austra -,12.05,,12595.6,Bills & Payments,Telecommunications
1/11/2023,Andrew Kay Manag Wages 29102023,,469,12607.65,Income,Salary
1/11/2023,Mcare Benefits 684169146 Gywq,,41.4,12138.65,Government payments,Centrelink payments
1/11/2023,Eftpos Debit                  01Nov16:15 Neuronau* Trip-Yq\,7.12,,12097.25,Transport & Travel,Vehicle Expenses
1/11/2023,Atm Withdrawal                01Nov15:30 Banksa                Adelaide     5  Au,200,,12104.37,Withdrawals & Transfers,ATM & EFTPOS
1/11/2023,Eftpos Debit                  01Nov02:49 Uber* Trip\,13.29,,12304.37,Transport & Travel,Taxi & Rental car
31/10/2023,Visa Purchase                 28Oct Sq *Africola Canteen Surry Hil,18,,12317.66,Entertainment & Recreation,Sports & Leisure
31/10/2023,Visa Purchase                 27Oct Bakery On O'Connell  North Ade,17.58,,12335.66,Food & Beverage,Food & Groceries
31/10/2023,Visa Purchase                 27Oct Memphis Slims House  Adelaide,15.25,,12353.24,Food & Beverage,Beverages
31/10/2023,Visa Purchase                 27Oct Independent 132211   Torrensvi,14.67,,12368.49,Transport & Travel,Taxi & Rental car
31/10/2023,Visa Purchase                 27Oct Memphis Slims House  Adelaide,11.18,,12383.16,Food & Beverage,Beverages
31/10/2023,Visa Purchase                 27Oct Memphis Slims House  Adelaide,11.18,,12394.34,Food & Beverage,Beverages
31/10/2023,Visa Purchase                 27Oct Beam Mobility Austra -,7.5,,12405.52,Bills & Payments,Telecommunications
31/10/2023,Visa Purchase                 29Oct Beam Mobility Austra -,7.5,,12413.02,Bills & Payments,Telecommunications
31/10/2023,Visa Purchase                 28Oct Beam Mobility Austra -,6.35,,12420.52,Bills & Payments,Telecommunications
31/10/2023,Eftpos Debit                  31Oct16:42 Neuronau* Trip-Jt\,6.1,,12426.87,Transport & Travel,Vehicle Expenses
30/10/2023,Visa Purchase                 27Oct Sp Usafoods Aus      Moorabbin,66.74,,12432.97,Home & Property,Technology & Appliances
30/10/2023,Visa Purchase                 27Oct Sq *Glam Medical Spa North Ade,65,,12499.71,Retail & Personal,Retail (shopping)
30/10/2023,Visa Purchase                 27Oct Nth Adel Foodland    North Ade,47.09,,12564.71,Food & Beverage,Food & Groceries
30/10/2023,Visa Purchase                 26Oct North Adelaide Haru  North Ade,10.2,,12611.8,Food & Beverage,Dining out
30/10/2023,Eftpos Debit                  30Oct09:31 Bakery On O'Connell   North Adelaidsa Au,11.72,,12622,Food & Beverage,Food & Groceries
28/10/2023,Visa Purchase                 25Oct Smp*The Flying Fig   North Ade,17.5,,12633.72,Food & Beverage,Food & Groceries
28/10/2023,Visa Purchase                 26Oct Beam Mobility Austra -,4.4,,12651.22,Bills & Payments,Telecommunications
28/10/2023,Visa Purchase                 26Oct Beam Mobility Austra -,3.25,,12655.62,Bills & Payments,Telecommunications
28/10/2023,Eftpos Debit                  28Oct17:30 Neuronau* Trip-Pm\,10.18,,12658.87,Transport & Travel,Vehicle Expenses
27/10/2023,Visa Purchase                 25Oct Aware Women's Health North Ade,96.75,,12669.05,Retail & Personal,Medical & Personal care
27/10/2023,Visa Purchase                 26Oct Amj Linn P/L&Ds&Jn   North Ade,88,,12765.8,Retail & Personal,Medical & Personal care
27/10/2023,Visa Purchase                 24Oct House Of Health Coll Adelaide,14.8,,12853.8,Food & Beverage,Food & Groceries
27/10/2023,Visa Purchase                 24Oct Smp*Atlas Continenta Adelaide,10.17,,12868.6,Food & Beverage,Dining out
27/10/2023,Visa Purchase                 25Oct Beam Mobility Austra -,7,,12878.77,Bills & Payments,Telecommunications
27/10/2023,Visa Purchase                 24Oct Hong Kong Grocery St Adelaide,4.99,,12885.77,Food & Beverage,Food & Groceries
27/10/2023,Visa Purchase                 24Oct Sq *Golden Hash Cafe North Ade,4,,12890.76,Food & Beverage,Dining out
26/10/2023,Visa Purchase                 24Oct The Coffee Bean Shop Welland,36.8,,12894.76,Food & Beverage,Beverages
26/10/2023,Visa Purchase                 24Oct Cappos Fish Market   Adelaide,27.35,,12931.56,Food & Beverage,Food & Groceries
26/10/2023,Visa Purchase                 23Oct Oconnell Convenience North Ade,16.29,,12958.91,Food & Beverage,Food & Groceries
26/10/2023,Mcare Benefits 680174897 Gywq,,41.2,12975.2,Government payments,Centrelink payments
25/10/2023,Visa Purchase                 23Oct North Adelaide Burge North Ade,36.5,,12934,Food & Beverage,Dining out
25/10/2023,Visa Purchase                 21Oct Nth Adel Foodland    North Ade,24.7,,12970.5,Food & Beverage,Food & Groceries
25/10/2023,Visa Purchase                 21Oct Nth Adel Foodland    North Ade,17.99,,12995.2,Food & Beverage,Food & Groceries
25/10/2023,Visa Purchase                 22Oct Nth Adel Foodland    North Ade,17.79,,13013.19,Food & Beverage,Food & Groceries
25/10/2023,Visa Purchase                 23Oct Nth Adel Foodland    North Ade,14.5,,13030.98,Food & Beverage,Food & Groceries
25/10/2023,Andrew Kay Manag Wages 22102023,,469,13045.48,Income,Salary
25/10/2023,Amusematte Austr Payroll15499,,132.5,12576.48,Income,Salary
25/10/2023,Mcare Benefits 679169222 Gywq,,41.2,12443.98,Government payments,Centrelink payments
25/10/2023,Tfr Wdl BPAY Internet         25Oct05:48 0207782150          Sa Water,169.37,,12402.78,Bills & Payments,Utilities & Rates
25/10/2023,Ato Ato005000018810510,,8597.9,12572.15,Government payments,Tax refunds
24/10/2023,Visa Purchase                 22Oct Sq *Glitterbuggin    Oaklands,72,,3974.25,Retail & Personal,Clothing & Shoes
24/10/2023,Visa Purchase                 22Oct Sq *Black Match Cand North Ade,50,,4046.25,Food & Beverage,Food & Groceries
24/10/2023,Visa Purchase                 21Oct Beam Mobility Austra -,6.35,,4096.25,Bills & Payments,Telecommunications
24/10/2023,Visa Purchase                 21Oct Officeworks          Bentleigh,0.3,,4102.6,Retail & Personal,Retail (shopping)
23/10/2023,Visa Purchase                 19Oct Tafe Sa Regency Camp Regency P,5.7,,4102.9,Retail & Personal,Education & Training
23/10/2023,Eftpos Debit                  23Oct09:31 Bakery On O'Connell   North Adelaidsa Au,15.45,,4108.6,Food & Beverage,Food & Groceries
21/10/2023,Visa Purchase                 19Oct 127 Days             Croydon P,21.5,,4124.05,Food & Beverage,Dining out
21/10/2023,Visa Purchase                 19Oct Nth Adel Foodland    North Ade,11,,4145.55,Food & Beverage,Food & Groceries
21/10/2023,Visa Purchase                 18Oct Bakery On O'Connell  North Ade,8.48,,4156.55,Food & Beverage,Food & Groceries
21/10/2023,Visa Purchase                 19Oct Sq *Village Asian Gr North Ade,6.25,,4165.03,Food & Beverage,Food & Groceries
21/10/2023,Visa Purchase                 18Oct Google Digibites     Pyrmont,0.79,,4171.28,Entertainment & Recreation,TV
21/10/2023,Eftpos Debit                  21Oct14:54 Neuronau* Trip-Fd\,6.61,,4172.07,Transport & Travel,Vehicle Expenses
21/10/2023,Atm Withdrawal                21Oct12:29 Banksa                Adelaide     5  Au,300,,4178.68,Withdrawals & Transfers,ATM & EFTPOS
21/10/2023,Eftpos Debit                  21Oct08:07 Uber* Trip\,14.39,,4478.68,Transport & Travel,Taxi & Rental car
21/10/2023,Eftpos Debit                  21Oct05:41 Uber* Trip\,16.71,,4493.07,Transport & Travel,Taxi & Rental car
20/10/2023,Visa Purchase                 17Oct Costco Wholesale Aus Kilburn,147.46,,4509.78,Food & Beverage,Food & Groceries
20/10/2023,Visa Purchase                 17Oct Couch Potato Co      Hindmarsh,78,,4657.24,Food & Beverage,Dining out
20/10/2023,Visa Purchase                 17Oct Costco Fuel Kilburn  Kilburn,46.49,,4735.24,Transport & Travel,Petrol
20/10/2023,Visa Purchase                 17Oct Governor Hindmarsh H Hindmarsh,22,,4781.73,Food & Beverage,Beverages
20/10/2023,Visa Purchase                 17Oct Smp*Atlas Continenta Adelaide,10.17,,4803.73,Food & Beverage,Dining out
20/10/2023,Tfr Wdl BPAY Internet         20Oct06:06 5092458412          Revsa - Esl,246.55,,4813.9,Bills & Payments,Tax payments
20/10/2023,Tfr Wdl BPAY Internet         20Oct06:06 5096073613          Revsa - Esl,143.7,,5060.45,Bills & Payments,Tax payments
19/10/2023,Visa Purchase                 17Oct Sq *Artist First Pty Brunswick,50,,5204.15,Retail & Personal,Clothing & Shoes
19/10/2023,Visa Purchase                 17Oct The Coffee Bean Shop Welland,23,,5254.15,Food & Beverage,Beverages
19/10/2023,Visa Purchase                 15Oct Bowden Brewing       Bowden,22,,5277.15,Food & Beverage,Beverages
19/10/2023,Visa Purchase                 16Oct Bakery On O'Connell  North Ade,11.11,,5299.15,Food & Beverage,Food & Groceries
19/10/2023,Visa Purchase                 17Oct Nth Adel Foodland    North Ade,8.25,,5310.26,Food & Beverage,Food & Groceries
18/10/2023,Visa Purchase                 16Oct Sq *2Nd Fix Doors &  180059531,56.21,,5318.51,Retail & Personal,Retail (shopping)
18/10/2023,Visa Purchase                 14Oct Nth Adel Foodland    North Ade,18.64,,5374.72,Food & Beverage,Food & Groceries
18/10/2023,Visa Purchase                 16Oct Lucia's Fine Foods   Adelaide,15,,5393.36,Food & Beverage,Food & Groceries
18/10/2023,Andrew Kay Manag Wages 15102023,,241,5408.36,Income,Salary
18/10/2023,Osko Withdrawal               18Oct13:14 5238 Quote 5238 2Nd Fix Hardware Pty Ltd,915.47,,5167.36,Withdrawals & Transfers,Withdrawal
17/10/2023,Visa Purchase                 15Oct Bowden Brewing       Bowden,43.73,,6082.83,Food & Beverage,Beverages
17/10/2023,Visa Purchase                 13Oct Bakery On O'Connell  North Ade,15.15,,6126.56,Food & Beverage,Food & Groceries
17/10/2023,Visa Purchase                 13Oct Beam Mobility Austra -,5.55,,6141.71,Bills & Payments,Telecommunications
16/10/2023,Visa Purchase                 12Oct Neuronau* Temphold-T Hawthorn,5.09,,6147.26,Transport & Travel,Vehicle Expenses
16/10/2023,Tfr Wdl BPAY Internet         16Oct05:45 500015101768        Origin Energy,1762.98,,6152.35,Bills & Payments,Utilities & Rates
16/10/2023,Eftpos Debit                  15Oct08:24 Uber* Trip\,20.01,,7915.33,Transport & Travel,Taxi & Rental car
16/10/2023,Eftpos Debit                  15Oct04:59 Uber* Trip\,19.97,,7935.34,Transport & Travel,Taxi & Rental car
14/10/2023,Visa Purchase                 12Oct Electrodry Adelaide  Magill,269,,7955.31,Home & Property,Services & Tradespeople
14/10/2023,Visa Purchase                 12Oct Beam Mobility Austra -,8.15,,8224.31,Bills & Payments,Telecommunications
14/10/2023,Visa Purchase                 12Oct Beam Mobility Austra -,7.65,,8232.46,Bills & Payments,Telecommunications
13/10/2023,Visa Purchase                 11Oct Nth Adel Foodland    North Ade,53.36,,8240.11,Food & Beverage,Food & Groceries
13/10/2023,Visa Purchase                 10Oct Smp*Cafe Fellini     North Ade,20.23,,8293.47,Food & Beverage,Dining out
13/10/2023,Visa Purchase                 11Oct Sq *Forestville Hc   Keswick T,5,,8313.7,Bills & Payments,Memberships
12/10/2023,Visa Purchase                 10Oct Beam Mobility Austra -,8.3,,8318.7,Bills & Payments,Telecommunications
12/10/2023,Visa Purchase                 10Oct Neuronau* Temphold-Y Hawthorn,3.55,,8327,Transport & Travel,Vehicle Expenses
12/10/2023,Eftpos Debit                  12Oct14:21 Brow Threads & Lashes Adelaide     Sa Au,12.13,,8330.55,Retail & Personal,Medical & Personal care
12/10/2023,Osko Withdrawal               12Oct12:57 Inv 36984 Expat Us Tax Pty Ltd,1831.5,,8342.68,Withdrawals & Transfers,Withdrawal
12/10/2023,Tfr Wdl BPAY Internet         12Oct06:06 500015101776        Origin Energy,194.63,,10174.18,Bills & Payments,Utilities & Rates
11/10/2023,Visa Purchase                 08Oct 299 Rundle Street Pt Adelaide,44.44,,10368.81,Food & Beverage,Beverages
11/10/2023,Visa Purchase                 09Oct Nth Adel Foodland    North Ade,30.29,,10413.25,Food & Beverage,Food & Groceries
11/10/2023,Visa Purchase                 08Oct Nth Adel Foodland    North Ade,8.8,,10443.54,Food & Beverage,Food & Groceries
11/10/2023,Foreign Currency Conversn Fee,0.1,,10452.34,Fees & Charges,Fees & Charges
11/10/2023,Visa Purchase O/Seas          07Oct Sgd2.99 2C2*Amznprimesg Memb,3.45,,10452.44,Retail & Personal,Retail (shopping)
11/10/2023,Andrew Kay Manag Wages 08102023,,469,10455.89,Income,Salary
11/10/2023,Eftpos Debit                  11Oct00:32 Hugh Hamilton Wines\,330,,9986.89,Retail & Personal,Retail (shopping)
10/10/2023,Visa Purchase                 07Oct Woodside Foodland    Woodside,10.5,,10316.89,Food & Beverage,Food & Groceries
10/10/2023,Visa Purchase                 08Oct Neuronau* Temphold-T Hawthorn,3.05,,10327.39,Transport & Travel,Vehicle Expenses
10/10/2023,Eftpos Debit                  10Oct18:49 Bakery On O'Connell   North Adelaidsa Au,11.11,,10330.44,Food & Beverage,Food & Groceries
10/10/2023,Atm Withdrawal                10Oct14:54 Banksa                Adelaide     5  Au,200,,10341.55,Withdrawals & Transfers,ATM & EFTPOS
9/10/2023,Visa Purchase                 06Oct Kanika Group Pty Ltd Prospect,100.42,,10541.55,Transport & Travel,Vehicle Expenses
9/10/2023,Visa Purchase                 06Oct Nth Adel Foodland    North Ade,11.79,,10641.97,Food & Beverage,Food & Groceries
7/10/2023,Visa Purchase                 05Oct Amj Linn P/L&Ds&Jn   North Ade,125.2,,10653.76,Retail & Personal,Medical & Personal care
7/10/2023,Eftpos Debit                  07Oct05:47 Uber* Trip\,14.62,,10778.96,Transport & Travel,Taxi & Rental car
6/10/2023,Visa Purchase                 03Oct Rickys Chicken Rice  North Ade,41.41,,10793.58,Food & Beverage,Dining out
6/10/2023,Visa Purchase                 04Oct Nth Adel Foodland    North Ade,35.04,,10834.99,Food & Beverage,Food & Groceries
6/10/2023,Visa Purchase                 03Oct Bakery On O'Connell  North Ade,6.06,,10870.03,Food & Beverage,Food & Groceries
6/10/2023,Osko Withdrawal               06Oct11:16 Kelly Payfer Bikes Only,731,,10876.09,Withdrawals & Transfers,Withdrawal
6/10/2023,Eftpos Debit                  06Oct09:35 Bakery On O'Connell   North Adelaidsa Au,16.77,,11607.09,Food & Beverage,Food & Groceries
6/10/2023,Eftpos Debit                  06Oct08:08 Uber Eats* Eats\,1.93,,11623.86,Food & Beverage,Dining out
5/10/2023,Visa Purchase                 03Oct Alh Venues/123 Oconn Nrth Adel,15.2,,11625.79,Transport & Travel,Hotels and Accommodation
5/10/2023,Visa Purchase                 03Oct Perryman S Bakery    North Ade,5.2,,11640.99,Food & Beverage,Food & Groceries
5/10/2023,Mcare Benefits 665167397 Gywq,,79.7,11646.19,Government payments,Centrelink payments
5/10/2023,Eftpos Credit                 05Oct20:09 Uber Eats* Eats\,,1.93,11566.49,Deposits,Deposit
5/10/2023,Eftpos Debit                  05Oct19:45 Uber Eats* Eats\,27.34,,11564.56,Food & Beverage,Dining out
4/10/2023,Visa Purchase                 30Sep Krung Thep           North Ade,58.5,,11591.9,Food & Beverage,Dining out
4/10/2023,Visa Purchase                 01Oct Nth Adel Foodland    North Ade,28.97,,11650.4,Food & Beverage,Food & Groceries
4/10/2023,Visa Purchase                 01Oct Bakery On O'Connell  North Ade,5.56,,11679.37,Food & Beverage,Food & Groceries
4/10/2023,Eftpos Debit                  04Oct15:49 Neuronau* Trip-Gr\,6.1,,11684.93,Transport & Travel,Vehicle Expenses
4/10/2023,Eftpos Debit                  04Oct15:00 Neuronau* Trip-Zp\,6.11,,11691.03,Transport & Travel,Vehicle Expenses
4/10/2023,Eftpos Debit                  04Oct12:14 Sq *Tynte Street Qualinorth Adelaidsa Au,51.52,,11697.14,Food & Beverage,Food & Groceries
3/10/2023,Visa Purchase                 01Oct Cafe Komodo          Prospect,67.24,,11748.66,Food & Beverage,Dining out
3/10/2023,Visa Purchase                 01Oct Patreon* Membership  Internet,36.85,,11815.9,Entertainment & Recreation,TV
3/10/2023,Visa Purchase                 29Sep Bakery On O'Connell  North Ade,11.41,,11852.75,Food & Beverage,Food & Groceries
3/10/2023,Visa Purchase                 29Sep House Of Health Coll Adelaide,6.7,,11864.16,Food & Beverage,Food & Groceries
2/10/2023,Visa Purchase                 29Sep Lucia's Fine Foods   Adelaide,15,,11870.86,Food & Beverage,Food & Groceries
2/10/2023,Visa Purchase                 28Sep Tafe Sa Regency Camp Regency P,7.2,,11885.86,Retail & Personal,Education & Training
2/10/2023,Visa Purchase                 29Sep Beam Mobility Austra -,7,,11893.06,Bills & Payments,Telecommunications
2/10/2023,Internet Deposit              02Oct11:52 From 9000204517840,,8500,11900.06,Deposits,Deposit
30/09/2023,Visa Purchase                 27Sep Smp*Cafe Fellini     North Ade,34.46,,3400.06,Food & Beverage,Dining out
30/09/2023,Visa Purchase                 27Sep Bakery On O'Connell  North Ade,10.4,,3434.52,Food & Beverage,Food & Groceries
30/09/2023,Eftpos Debit                  30Sep14:26 Neuronau* Trip-Bj\,6.61,,3444.92,Transport & Travel,Vehicle Expenses
30/09/2023,Eftpos Debit                  30Sep13:30 Neuronau* Trip-N6\,6.62,,3451.53,Transport & Travel,Vehicle Expenses
29/09/2023,Visa Purchase                 25Sep Amazon Marketplace A Sydney So,94.94,,3458.15,Retail & Personal,Retail (shopping)
29/09/2023,Visa Purchase                 25Sep Jm Deli And Bakery   Port Augu,26.9,,3553.09,Food & Beverage,Food & Groceries
29/09/2023,Visa Purchase                 27Sep Nth Adel Foodland    North Ade,25.84,,3579.99,Food & Beverage,Food & Groceries
29/09/2023,Visa Purchase                 26Sep Jm Deli And Bakery   Port Augu,13,,3605.83,Food & Beverage,Food & Groceries
29/09/2023,Eftpos Debit                  29Sep15:34 Neuronau* Trip-7R\,7.12,,3618.83,Transport & Travel,Vehicle Expenses
28/09/2023,Visa Purchase                 25Sep Standpipe Restaurant Port Augu,387,,3625.95,Food & Beverage,Dining out
28/09/2023,Visa Purchase                 26Sep Nth Adel Foodland    North Ade,32.7,,4012.95,Food & Beverage,Food & Groceries
28/09/2023,Visa Purchase                 25Sep Sq *Mamma Lou?S      Port Augu,28.4,,4045.65,Food & Beverage,Food & Groceries
28/09/2023,Visa Purchase                 26Sep Sq *Warnertown Baker Warnertow,21.1,,4074.05,Food & Beverage,Food & Groceries
28/09/2023,Visa Purchase                 24Sep Pastoral Hotel Motel Port Augu,17,,4095.15,Transport & Travel,Hotels and Accommodation
28/09/2023,Visa Purchase                 24Sep Pastoral Hotel Motel Port Augu,12.12,,4112.15,Transport & Travel,Hotels and Accommodation
27/09/2023,Deft Payments Deft      20294476,942.99,,4124.27,Bills & Payments,Expenses & Payments
27/09/2023,Visa Purchase                 25Sep Saltbush Surf Pty Lt Port Augu,44.95,,5067.26,Entertainment & Recreation,Sports & Leisure
27/09/2023,Visa Purchase                 23Sep Bettys Burgers Austr Norwood,26.5,,5112.21,Food & Beverage,Dining out
27/09/2023,Visa Purchase                 25Sep Patreon* Membership  Internet,18.7,,5138.71,Retail & Personal,Retail (shopping)
26/09/2023,Visa Purchase                 22Sep Ferve Adl Film Fest  Cheltenha,143.85,,5157.41,Home & Property,Services & Tradespeople
26/09/2023,Visa Purchase                 22Sep Ferve Adl Film Fest  Cheltenha,105.49,,5301.26,Home & Property,Services & Tradespeople
26/09/2023,Visa Purchase                 22Sep Bakery On O'Connell  North Ade,24.44,,5406.75,Food & Beverage,Food & Groceries
26/09/2023,Visa Purchase                 22Sep Jurack Pty Ltd       Adelaide,23,,5431.19,Transport & Travel,Hotels and Accommodation
26/09/2023,Visa Purchase                 22Sep Great Silver Ocean P North Ade,12.9,,5454.19,Food & Beverage,Dining out
26/09/2023,Visa Purchase                 22Sep Beam Mobility Austra -,8.8,,5467.09,Bills & Payments,Telecommunications
26/09/2023,Visa Purchase                 23Sep Cafe Bravo Norwood   Norwood,4.9,,5475.89,Food & Beverage,Dining out
25/09/2023,Visa Purchase                 22Sep Excel Nails          North Ade,30,,5480.79,Retail & Personal,Retail (shopping)
25/09/2023,Visa Purchase                 21Sep Tafe Sa Regency Camp Regency P,12.7,,5510.79,Retail & Personal,Education & Training
25/09/2023,Visa Purchase                 21Sep Neuronau* Temphold-H Hawthorn,5.08,,5523.49,Transport & Travel,Vehicle Expenses
23/09/2023,Visa Purchase                 21Sep Nth Adel Foodland    North Ade,18.75,,5528.57,Food & Beverage,Food & Groceries
23/09/2023,Visa Purchase                 20Sep Bakery On O'Connell  North Ade,9.9,,5547.32,Food & Beverage,Food & Groceries
23/09/2023,Eftpos Debit                  23Sep07:51 Uber* Trip\,12.72,,5557.22,Transport & Travel,Taxi & Rental car
22/09/2023,Visa Purchase                 19Sep Costco Wholesale Aus Kilburn,108.74,,5569.94,Food & Beverage,Food & Groceries
22/09/2023,Visa Purchase                 20Sep Excel Nails          North Ade,25,,5678.68,Retail & Personal,Retail (shopping)
22/09/2023,Visa Purchase                 19Sep Costco Fuel Kilburn  Kilburn,23.88,,5703.68,Transport & Travel,Petrol
22/09/2023,Visa Purchase                 19Sep Momoshi Pty Ltd      Kilburn,19.9,,5727.56,Food & Beverage,Dining out
22/09/2023,Osko Withdrawal               22Sep11:31 340366 340366 Ken Hall Plumbers Pty Ltd,383.82,,5747.46,Withdrawals & Transfers,Withdrawal
21/09/2023,Visa Purchase                 19Sep Fresh Point Churchil Kilburn,22.98,,6131.28,Food & Beverage,Food & Groceries
21/09/2023,Eftpos Debit                  21Sep05:43 Uber* Trip\,14.22,,6154.26,Transport & Travel,Taxi & Rental car
20/09/2023,Visa Purchase                 16Sep Eb *Georges Friends  801-413-7,182.62,,6168.48,Bills & Payments,Expenses & Payments
