Date,Description,Debit,Credit,Balance,Category,SubCategory
1/11/2024,Osko Withdrawal               01Nov19:34 Michelle,300,,708721.39,Withdrawals & Transfers,Withdrawal
1/11/2024,Atm Withdrawal                01Nov15:50 Rundle Place Os          Adelaide     Au,800,,709021.39,Withdrawals & Transfers,ATM & EFTPOS
1/11/2024,Internet Deposit              01Nov10:17 From 9000204517840,,21000,709821.39,Deposits,Deposit
1/11/2024,Smith Partners R 005T7Lf Payment To,,1333.88,688821.39,Deposits,Deposit
1/11/2024,Osko Withdrawal               31Oct22:42 Magda,250,,687487.51,Withdrawals & Transfers,Withdrawal
1/11/2024,Osko Withdrawal               31Oct22:41 Ada,250,,687737.51,Withdrawals & Transfers,Withdrawal
31/10/2024,Overseas Withdrawal Fee,5,,687987.51,Fees & Charges,Fees & Charges
31/10/2024,Visa Purchase                 29Oct City Bbq & Yum Cha P Rundle Ma,23.7,,687992.51,Food & Beverage,Dining out
31/10/2024,Internet Withdrawal           31Oct05:56 To 1160084689040,200,,688016.21,Withdrawals & Transfers,Funds transfer
31/10/2024,Internet Withdrawal           31Oct05:56 To 0280074830940,800,,688216.21,Withdrawals & Transfers,Funds transfer
31/10/2024,Internet Withdrawal           31Oct05:56 To 802-919 001908567,1000,,689016.21,Withdrawals & Transfers,Funds transfer
30/10/2024,Visa Purchase                 28Oct Prestige Dry Clean   North Ade,70,,690016.21,Home & Property,Services & Tradespeople
30/10/2024,Visa Purchase                 28Oct Ezymart 118 King Wil Adelaide,21.8,,690086.21,Food & Beverage,Food & Groceries
30/10/2024,Visa Purchase                 28Oct Linda Erica Shackloc Adelaide,9.6,,690108.01,Retail & Personal,Medical & Personal care
29/10/2024,Raa 35878759_12_1,31.5,,690117.61,Transport & Travel,Vehicle Expenses
29/10/2024,Visa Purchase                 25Oct Bakery On O'Connell  North Ade,22.73,,690149.11,Food & Beverage,Food & Groceries
29/10/2024,Raa 37652251_1_1,19.99,,690171.84,Transport & Travel,Vehicle Expenses
29/10/2024,Visa Purchase                 26Oct Bakery On O'Connell  North Ade,18.18,,690191.83,Food & Beverage,Food & Groceries
29/10/2024,Visa Purchase                 27Oct Zlr*Metropolitan Fre North Ade,8.12,,690210.01,Food & Beverage,Food & Groceries
29/10/2024,Eftpos Debit                  29Oct08:59 Beem\\0Edd8Ebd64D24B4582B9Ac228Ee97E14,250,,690218.13,Withdrawals & Transfers,Funds transfer
28/10/2024,Visa Purchase                 24Oct Yakitori Takumi      North Ade,221.92,,690468.13,Food & Beverage,Dining out
28/10/2024,Visa Purchase                 25Oct Krung Thep           North Ade,56.42,,690690.05,Food & Beverage,Dining out
28/10/2024,Visa Purchase                 25Oct City Bbq & Yum Cha P Rundle Ma,23.7,,690746.47,Food & Beverage,Dining out
28/10/2024,Visa Purchase                 24Oct Bakery On O'Connell  North Ade,19.49,,690770.17,Food & Beverage,Food & Groceries
28/10/2024,Visa Purchase                 24Oct Bakery On O'Connell  North Ade,9.8,,690789.66,Food & Beverage,Food & Groceries
28/10/2024,Atm Withdrawal                28Oct16:27 Atmx 139 Oconnell St   North Adelaid08Au,2000,,690799.46,Withdrawals & Transfers,ATM & EFTPOS
28/10/2024,Atm Withdrawal                27Oct16:13 Atmx 139 Oconnell St   North Adelaid08Au,1000,,692799.46,Withdrawals & Transfers,ATM & EFTPOS
28/10/2024,Osko Withdrawal               27Oct00:07 Finley Greenhill Galea,1500,,693799.46,Withdrawals & Transfers,Withdrawal
26/10/2024,Visa Purchase                 23Oct Bakery On O'Connell  North Ade,12.12,,695299.46,Food & Beverage,Food & Groceries
26/10/2024,Osko Withdrawal               25Oct22:34 Finley Greenhill Galea,1200,,695311.58,Withdrawals & Transfers,Withdrawal
25/10/2024,Visa Purchase                 23Oct City Bbq & Yum Cha P Rundle Ma,23.7,,696511.58,Food & Beverage,Dining out
25/10/2024,Osko Withdrawal               25Oct11:16 Kelly Deen,1900,,696535.28,Withdrawals & Transfers,Withdrawal
24/10/2024,Visa Purchase                 22Oct 34 Wyatt Street      Adelaide,21.21,,698435.28,Food & Beverage,Dining out
24/10/2024,Visa Purchase                 21Oct Bakery On O'Connell  North Ade,12.12,,698456.49,Food & Beverage,Food & Groceries
24/10/2024,Visa Purchase                 22Oct Coles 4964           Adelaide,4,,698468.61,Food & Beverage,Food & Groceries
24/10/2024,Internet Withdrawal           24Oct06:00 To 0280074830940,800,,698472.61,Withdrawals & Transfers,Funds transfer
24/10/2024,Internet Withdrawal           24Oct06:00 To 802-919 001908567,1000,,699272.61,Withdrawals & Transfers,Funds transfer
24/10/2024,Osko Deposit                  23Oct23:44 Finley Greenhill Galea,,180,700272.61,Deposits,Deposit
23/10/2024,Visa Purchase                 20Oct Bakery On O'Connell  North Ade,30.3,,700092.61,Food & Beverage,Food & Groceries
23/10/2024,Foreign Currency Conversn Fee,0.89,,700122.91,Fees & Charges,Fees & Charges
23/10/2024,Visa Purchase O/Seas          21Oct Usd20.00 Claude.Ai Subscripti,29.9,,700123.8,Home & Property,Technology & Appliances
23/10/2024,Osko Withdrawal               23Oct19:58 Finley Greenhill Galea,600,,700153.7,Withdrawals & Transfers,Withdrawal
23/10/2024,Osko Withdrawal               23Oct19:52 Finley Greenhill Galea,400,,700753.7,Withdrawals & Transfers,Withdrawal
23/10/2024,Atm Withdrawal                23Oct13:56 Rundle Place Os          Adelaide     Au,500,,701153.7,Withdrawals & Transfers,ATM & EFTPOS
22/10/2024,Visa Purchase                 17Oct Bakery On O'Connell  North Ade,12.12,,701653.7,Food & Beverage,Food & Groceries
22/10/2024,Visa Purchase                 19Oct Google Youtube Membe Pyrmont,3.99,,701665.82,Entertainment & Recreation,TV
22/10/2024,Atm Withdrawal                22Oct12:43 Rundle Place Os          Adelaide     Au,2000,,701669.81,Withdrawals & Transfers,ATM & EFTPOS
21/10/2024,Allianz Aust 1Rd221368013224295,172.39,,703669.81,Bills & Payments,Insurance
21/10/2024,Allianz Aust 1Rd220985013224295,23.13,,703842.2,Bills & Payments,Insurance
21/10/2024,Osko Withdrawal               20Oct17:04 Magda,2000,,703865.33,Withdrawals & Transfers,Withdrawal
19/10/2024,Visa Purchase                 15Oct Sa Water             Adelaide,371.06,,705865.33,Bills & Payments,Utilities & Rates
19/10/2024,Visa Purchase                 16Oct Bakery On O'Connell  North Ade,7.07,,706236.39,Food & Beverage,Food & Groceries
19/10/2024,Internet Deposit              19Oct19:45 Ada Lili,,20,706243.46,Deposits,Deposit
19/10/2024,Tfr Wdl BPAY Internet         19Oct11:13 0044605194          Deft Rent,980,,706223.46,Home & Property,Mortgage & Rent
19/10/2024,Internet Withdrawal           19Oct10:51 To 1160084689040,310,,707203.46,Withdrawals & Transfers,Funds transfer
18/10/2024,Visa Purchase                 15Oct Bakery On O'Connell  North Ade,12.12,,707513.46,Food & Beverage,Food & Groceries
17/10/2024,Internet Withdrawal           17Oct05:57 To 0280074830940,800,,707525.58,Withdrawals & Transfers,Funds transfer
17/10/2024,Internet Withdrawal           17Oct05:57 To 1160084689040,320,,708325.58,Withdrawals & Transfers,Funds transfer
17/10/2024,Internet Withdrawal           17Oct05:57 To 802-919 001908567,1000,,708645.58,Withdrawals & Transfers,Funds transfer
16/10/2024,Loan Repayment S.514.2655406.00,4924,,709645.58,Home & Property,Mortgage & Rent
15/10/2024,Visa Purchase                 11Oct Airbnb * Hms4Ddqp9W  Surry Hil,150.77,,714569.58,Transport & Travel,Hotels and Accommodation
15/10/2024,Visa Purchase                 11Oct Hsp Sa No. 1 Pty Ltd Ashford,21.27,,714720.35,Retail & Personal,Medical & Personal care
15/10/2024,Smith Partners R 005S96X Payment To,,1255.28,714741.62,Deposits,Deposit
14/10/2024,Raa 37596091_1_1,93.75,,713486.34,Transport & Travel,Vehicle Expenses
12/10/2024,Visa Purchase                 08Oct Epoch.Com   *Tecomlt Limassol,85.97,,713580.09,Retail & Personal,Retail (shopping)
12/10/2024,Osko Withdrawal               12Oct04:00 Magda,500,,713666.06,Withdrawals & Transfers,Withdrawal
11/10/2024,Visa Purchase                 10Oct Medibank Phi Debit   Melbourne,573.65,,714166.06,Bills & Payments,Insurance
11/10/2024,Tfr Wdl BPAY Internet         11Oct17:59 62345302145         Optus Billing Svcs,200,,714739.71,Bills & Payments,Telecommunications
11/10/2024,Osko Withdrawal               11Oct11:22 Kelly Deen,1900,,714939.71,Withdrawals & Transfers,Withdrawal
11/10/2024,Atm Withdrawal                11Oct09:44 Atmx 139 Oconnell St   North Adelaid08Au,2000,,716839.71,Withdrawals & Transfers,ATM & EFTPOS
10/10/2024,Internet Withdrawal           10Oct06:00 To 0280074830940,800,,718839.71,Withdrawals & Transfers,Funds transfer
10/10/2024,Internet Withdrawal           10Oct06:00 To 1160084689040,320,,719639.71,Withdrawals & Transfers,Funds transfer
10/10/2024,Internet Withdrawal           10Oct06:00 To 802-919 001908567,1000,,719959.71,Withdrawals & Transfers,Funds transfer
10/10/2024,Internet Withdrawal           09Oct22:36 To 1160084689040,50,,720959.71,Withdrawals & Transfers,Funds transfer
9/10/2024,Visa Purchase                 06Oct Ezyreg Sa            Adelaide,196.62,,721009.71,Bills & Payments,Professional & Govt services
9/10/2024,Internet Withdrawal           09Oct15:25 To 9000204517840,2000,,721206.33,Withdrawals & Transfers,Funds transfer
9/10/2024,Internet Withdrawal           09Oct12:52 To 1160084689040,300,,723206.33,Withdrawals & Transfers,Funds transfer
8/10/2024,Foreign Currency Conversn Fee,1.5,,723506.33,Fees & Charges,Fees & Charges
8/10/2024,Visa Cash Advance             06Oct Twd1100.00 China Trust Bank/049,50.18,,723507.83,Withdrawals & Transfers,Funds transfer
8/10/2024,Raa 37078205_4_1,22.25,,723558.01,Transport & Travel,Vehicle Expenses
8/10/2024,Tfr Wdl BPAY Internet         08Oct21:58 0044605194          Deft Rent,980,,723580.26,Home & Property,Mortgage & Rent
8/10/2024,Internet Withdrawal           08Oct21:49 To 1160084689040,59,,724560.26,Withdrawals & Transfers,Funds transfer
5/10/2024,Osko Withdrawal               05Oct21:58 Ada,75,,724619.26,Withdrawals & Transfers,Withdrawal
4/10/2024,Osko Withdrawal               04Oct15:02 Magda,750,,724694.26,Withdrawals & Transfers,Withdrawal
3/10/2024,Visa Purchase                 30Sep Bakery On O'Connell  North Ade,12.12,,725444.26,Food & Beverage,Food & Groceries
3/10/2024,Osko Withdrawal               03Oct11:16 As Req K Bond,2000,,725456.38,Withdrawals & Transfers,Withdrawal
3/10/2024,Internet Withdrawal           03Oct05:58 To 802-919 001908567,1000,,727456.38,Withdrawals & Transfers,Funds transfer
2/10/2024,Visa Cash Advance             01Oct Cathay United Bank   Taipei,961.37,,728456.38,Withdrawals & Transfers,Funds transfer
2/10/2024,Visa Purchase                 30Sep City Bbq & Yum Cha P Rundle Ma,23.4,,729417.75,Food & Beverage,Dining out
2/10/2024,Internet Deposit              02Oct12:48 From 9000204517840,,6000,729441.15,Deposits,Deposit
1/10/2024,American Express 376012649071009,1295.08,,723441.15,Bills & Payments,Expenses & Payments
1/10/2024,Visa Purchase                 28Sep Bws/123 Oconnell Str Nrth Adel,136,,724736.23,Food & Beverage,Beverages
1/10/2024,Smith Partners R 005R9T8 Payment To,,1255.28,724872.23,Deposits,Deposit
30/09/2024,American Express 376012649071009,39484.19,,723616.95,Bills & Payments,Expenses & Payments
30/09/2024,Raa 35878759_11_1,31.5,,763101.14,Transport & Travel,Vehicle Expenses
30/09/2024,Visa Purchase                 27Sep Ezymart 118 King Wil Adelaide,22.8,,763132.64,Food & Beverage,Food & Groceries
30/09/2024,Visa Purchase                 26Sep Brighton & Seacliff  Seacliff,22.8,,763155.44,Food & Beverage,Dining out
30/09/2024,Visa Purchase                 26Sep Brighton & Seacliff  Seacliff,22.8,,763178.24,Food & Beverage,Dining out
30/09/2024,Raa 35676928_12_1,18.25,,763201.04,Transport & Travel,Vehicle Expenses
30/09/2024,Cardless Atm Withdrawal       30Sep10:32 Rundle Place Os          Adelaide     Au,500,,763219.29,Withdrawals & Transfers,ATM & EFTPOS
30/09/2024,Internet Overseas Tt          30Sep00:53,1500,,763719.29,Withdrawals & Transfers,Funds transfer
30/09/2024,Internet Tt Req Fee           30Sep00:53,20,,765219.29,Withdrawals & Transfers,Funds transfer
28/09/2024,Visa Purchase                 25Sep Wink Wealth Pty L Td Frenchs F,115.2,,765239.29,Entertainment & Recreation,TV
28/09/2024,Eftpos Debit                  28Sep14:22 Sq *Ricky's Chicken Rinorth Adelaidsa Au,20.74,,765354.49,Food & Beverage,Dining out
27/09/2024,Visa Purchase                 25Sep Kate Le Cong         Adelaide,61.25,,765375.23,Retail & Personal,Medical & Personal care
27/09/2024,Visa Purchase                 24Sep Bakery On O'Connell  North Ade,6.06,,765436.48,Food & Beverage,Food & Groceries
27/09/2024,Osko Withdrawal               27Sep12:26 Ada,1000,,765442.54,Withdrawals & Transfers,Withdrawal
26/09/2024,Visa Purchase                 23Sep Bakery On O'Connell  North Ade,17.68,,766442.54,Food & Beverage,Food & Groceries
26/09/2024,Rtgs High Value Pymt Cr 1987893 St James Place In Bsb Number 105,,223561.51,766460.22,Deposits,Deposit
26/09/2024,Internet Withdrawal           26Sep06:01 To 1160084689040,800,,542898.71,Withdrawals & Transfers,Funds transfer
26/09/2024,Internet Withdrawal           26Sep06:01 To 802-919 001908567,1000,,543698.71,Withdrawals & Transfers,Funds transfer
25/09/2024,Visa Purchase                 23Sep Sq *Nanyang Cafe ??? Adelaide,19.53,,544698.71,Food & Beverage,Dining out
25/09/2024,Medibank Private 105021483253,,319.75,544718.24,Deposits,Insurance
25/09/2024,Mcare Benefits 912166887 Gywq,,19.6,544398.49,Government payments,Centrelink payments
25/09/2024,Osko Withdrawal               24Sep22:35 Magda,1000,,544378.89,Withdrawals & Transfers,Withdrawal
24/09/2024,Visa Purchase                 20Sep Ebay O*12-12091-7581 Sydney,350,,545378.89,Retail & Personal,Retail (shopping)
24/09/2024,Osko Withdrawal               24Sep19:21 S L Koch,1700,,545728.89,Withdrawals & Transfers,Withdrawal
24/09/2024,Atm Withdrawal                24Sep11:24 Atmx 139 Oconnell St   North Adelaid08Au,2000,,547428.89,Withdrawals & Transfers,ATM & EFTPOS
23/09/2024,Allianz Aust 1Rd221368019924267,172.39,,549428.89,Bills & Payments,Insurance
23/09/2024,Allianz Aust 1Rd220985019924267,23.13,,549601.28,Bills & Payments,Insurance
23/09/2024,Visa Purchase                 20Sep City Bbq & Yum Cha P Rundle Ma,19.6,,549624.41,Food & Beverage,Dining out
23/09/2024,Visa Purchase                 20Sep City Cross Ezy Store Adelaide,7.3,,549644.01,Food & Beverage,Food & Groceries
23/09/2024,Atm Withdrawal                23Sep15:46 Atmx 139 Oconnell St   North Adelaid08Au,2000,,549651.31,Withdrawals & Transfers,ATM & EFTPOS
23/09/2024,Osko Withdrawal               22Sep15:06 Kelly Deen,1900,,551651.31,Withdrawals & Transfers,Withdrawal
21/09/2024,Visa Purchase                 18Sep Bakery On O'Connell  North Ade,24.75,,553551.31,Food & Beverage,Food & Groceries
21/09/2024,Visa Purchase                 19Sep Tea Tree Infinity Pt Adelaide,15.53,,553576.06,Food & Beverage,Dining out
21/09/2024,Visa Purchase                 18Sep Bakery On O'Connell  North Ade,9.09,,553591.59,Food & Beverage,Food & Groceries
21/09/2024,Visa Purchase                 19Sep Google Youtube Membe Pyrmont,3.99,,553600.68,Entertainment & Recreation,TV
19/09/2024,Visa Purchase                 16Sep Airbnb * Hms4Ddqp9W  Surry Hil,4375.6,,553604.67,Transport & Travel,Hotels and Accommodation
19/09/2024,Cardless Atm Withdrawal       19Sep15:08 Rundle Place Os          Adelaide     Au,500,,557980.27,Withdrawals & Transfers,ATM & EFTPOS
19/09/2024,Internet Withdrawal           19Sep05:57 To 1160084689040,800,,558480.27,Withdrawals & Transfers,Funds transfer
19/09/2024,Internet Withdrawal           19Sep05:57 To 802-919 001908567,1000,,559280.27,Withdrawals & Transfers,Funds transfer
19/09/2024,Osko Withdrawal               18Sep23:52 Swag Magda,1500,,560280.27,Withdrawals & Transfers,Withdrawal
18/09/2024,Visa Purchase                 14Sep Standpipe Restaurant Port Augu,24,,561780.27,Food & Beverage,Dining out
18/09/2024,Visa Purchase                 14Sep Remarkable Hotels    Wilmingto,9.5,,561804.27,Transport & Travel,Hotels and Accommodation
18/09/2024,Visa Purchase                 14Sep Orroroo Hotel        Orroroo,9.07,,561813.77,Food & Beverage,Beverages
17/09/2024,Visa Purchase                 13Sep Elite Fuels Pty Ltd  Melrose,18.21,,561822.84,Transport & Travel,Petrol
17/09/2024,Annual Package Fee  506149558 Advantage,395,,561841.05,Fees & Charges,Fees & Charges
16/09/2024,Raa 35616154_12_1,78.58,,562236.05,Transport & Travel,Vehicle Expenses
16/09/2024,Visa Purchase                 13Sep Tarlee Bakery        Tarlee,13.26,,562314.63,Food & Beverage,Food & Groceries
16/09/2024,Smith Partners R 005Q8Mb Payment To,,2510.56,562327.89,Deposits,Deposit
16/09/2024,Loan Repayment S.514.2655406.00,4924,,559817.33,Home & Property,Mortgage & Rent
16/09/2024,Osko Withdrawal               16Sep14:19 Aircon Install Airtech,10890,,564741.33,Withdrawals & Transfers,Withdrawal
14/09/2024,Visa Purchase                 12Sep Just Guys Sa Pty Ltd Adelaide,35,,575631.33,Retail & Personal,Retail (shopping)
14/09/2024,Visa Purchase                 11Sep Bakery On O'Connell  North Ade,18.48,,575666.33,Food & Beverage,Food & Groceries
14/09/2024,Osko Withdrawal               14Sep19:53 Kelly Deen,1900,,575684.81,Withdrawals & Transfers,Withdrawal
14/09/2024,Eftpos Debit                  14Sep13:58 Hunts Fuel            Orroroo      Sa Au,4.57,,577584.81,Transport & Travel,Petrol
14/09/2024,Atm Withdrawal -Wbc           14Sep09:55 Westpac               Port Augusta 5  Au,500,,577589.38,Withdrawals & Transfers,ATM & EFTPOS
13/09/2024,Osko Withdrawal               13Sep20:20 Ada,1000,,578089.38,Withdrawals & Transfers,Withdrawal
12/09/2024,Visa Purchase                 10Sep City Bbq & Yum Cha P Rundle Ma,19.6,,579089.38,Food & Beverage,Dining out
12/09/2024,Visa Purchase                 10Sep 2Co.Com*Revouninstal Amsterdam,18.74,,579108.98,Home & Property,Technology & Appliances
12/09/2024,Mcare Benefits 903174694 Eywq,,104.05,579127.72,Government payments,Centrelink payments
12/09/2024,Internet Withdrawal           12Sep06:00 To 1160084689040,800,,579023.67,Withdrawals & Transfers,Funds transfer
12/09/2024,Internet Withdrawal           12Sep06:00 To 802-919 001908567,1000,,579823.67,Withdrawals & Transfers,Funds transfer
11/09/2024,Visa Purchase                 10Sep Medibank Phi Debit   Melbourne,573.65,,580823.67,Bills & Payments,Insurance
11/09/2024,Visa Purchase                 09Sep Kate Le Cong         Adelaide,107.35,,581397.32,Retail & Personal,Medical & Personal care
11/09/2024,Osko Withdrawal               11Sep16:11 Adelaide Retro Motorcycles,390,,581504.67,Withdrawals & Transfers,Withdrawal
10/09/2024,Visa Purchase                 08Sep Ebay O*10-12042-6558 Sydney,395.99,,581894.67,Retail & Personal,Retail (shopping)
10/09/2024,Visa Purchase                 07Sep Bakery On O'Connell  North Ade,19.49,,582290.66,Food & Beverage,Food & Groceries
10/09/2024,Visa Purchase                 07Sep Bakery On O'Connell  North Ade,9.09,,582310.15,Food & Beverage,Food & Groceries
10/09/2024,Atm Withdrawal                10Sep12:48 Rundle Place Os          Adelaide     Au,1100,,582319.24,Withdrawals & Transfers,ATM & EFTPOS
9/09/2024,Visa Purchase                 05Sep Bakery On O'Connell  North Ade,26.77,,583419.24,Food & Beverage,Food & Groceries
9/09/2024,Visa Purchase                 05Sep Brighton & Seacliff  Seacliff,11,,583446.01,Food & Beverage,Dining out
9/09/2024,Mcare Benefits 900172665 Gywq,,42.85,583457.01,Government payments,Centrelink payments
7/09/2024,Visa Purchase                 05Sep Brighton & Seacliff  Seacliff,22.8,,583414.16,Food & Beverage,Dining out
7/09/2024,Visa Purchase                 05Sep Brighton & Seacliff  Seacliff,22.8,,583436.96,Food & Beverage,Dining out
7/09/2024,Visa Purchase                 04Sep Bakery On O'Connell  North Ade,12.12,,583459.76,Food & Beverage,Food & Groceries
6/09/2024,Raa 37078205_3_1,22.25,,583471.88,Transport & Travel,Vehicle Expenses
6/09/2024,Osko Withdrawal               06Sep18:03 Seone Needs To Pay For Magda,750,,583494.13,Withdrawals & Transfers,Withdrawal
5/09/2024,Visa Purchase                 02Sep T Phans Snack Bar    Adelaide,15.67,,584244.13,Food & Beverage,Dining out
5/09/2024,Atm Withdrawal                05Sep12:40 Atmx 139 Oconnell St   North Adelaid08Au,1500,,584259.8,Withdrawals & Transfers,ATM & EFTPOS
5/09/2024,Osko Withdrawal               05Sep10:02 Transfer Of Monies For Dean  & Colleen L,99900,,585759.8,Withdrawals & Transfers,Withdrawal
5/09/2024,Internet Withdrawal           05Sep05:57 To 1160084689040,800,,685659.8,Withdrawals & Transfers,Funds transfer
5/09/2024,Internet Withdrawal           05Sep05:57 To 802-919 001908567,1000,,686459.8,Withdrawals & Transfers,Funds transfer
4/09/2024,Atm Operator Fee Wdl          04Sep18:14 Royal Oak Nth Adl     Nrth Adelaid    Au,3.2,,687459.8,Fees & Charges,Fees & Charges
4/09/2024,Atm Withdrawal                04Sep18:14 Royal Oak Nth Adl     Nrth Adelaid    Au,250,,687463,Withdrawals & Transfers,ATM & EFTPOS
3/09/2024,Visa Purchase                 30Aug Jonathan Chuang Hao  North Ade,240,,687713,Retail & Personal,Medical & Personal care
3/09/2024,Visa Purchase                 30Aug Trybooking*Muf       South Yar,100.5,,687953,Bills & Payments,Expenses & Payments
3/09/2024,Visa Purchase                 31Aug Bakery On O'Connell  North Ade,20.51,,688053.5,Food & Beverage,Food & Groceries
3/09/2024,Internet Withdrawal           03Sep16:29 To 1160084689040,150,,688074.01,Withdrawals & Transfers,Funds transfer
2/09/2024,Visa Purchase                 29Aug He & Huo Family Pty  Hazelwood,95,,688224.01,Retail & Personal,Medical & Personal care
2/09/2024,Visa Purchase                 30Aug City Bbq & Yum Cha P Rundle Ma,19.6,,688319.01,Food & Beverage,Dining out
2/09/2024,Atm Withdrawal                02Sep17:18 Rundle Place Os          Adelaide     Au,2000,,688338.61,Withdrawals & Transfers,ATM & EFTPOS
2/09/2024,Internet Deposit              02Sep12:34 From 9000204517840,,20000,690338.61,Deposits,Deposit
2/09/2024,Smith Partners R 005Pjgg Payment To,,1255.28,670338.61,Deposits,Deposit
31/08/2024,Foreign Currency Conversn Fee,0.79,,669083.33,Fees & Charges,Fees & Charges
31/08/2024,Visa Purchase O/Seas          29Aug Usd18.00 Www.Downloadhelper.N,26.62,,669084.12,Entertainment & Recreation,TV
31/08/2024,Visa Purchase                 29Aug Brighton & Seacliff  Seacliff,22.8,,669110.74,Food & Beverage,Dining out
31/08/2024,Atm Withdrawal                31Aug09:14 Atmx 139 Oconnell St   North Adelaid08Au,1000,,669133.54,Withdrawals & Transfers,ATM & EFTPOS
30/08/2024,Mcare Benefits 894140687 Gywq,,84.15,670133.54,Government payments,Centrelink payments
30/08/2024,Osko Withdrawal               30Aug18:06 Magda,1000,,670049.39,Withdrawals & Transfers,Withdrawal
30/08/2024,Osko Withdrawal               30Aug11:38 Jodi Godby,150,,671049.39,Withdrawals & Transfers,Withdrawal
30/08/2024,Tfr Wdl BPAY Internet         30Aug06:03 111534              City Of Adelaide,742,,671199.39,Bills & Payments,Tax payments
29/08/2024,Raa 35878759_10_1,31.5,,671941.39,Transport & Travel,Vehicle Expenses
29/08/2024,Raa 35676928_11_1,18.25,,671972.89,Transport & Travel,Vehicle Expenses
29/08/2024,Visa Purchase                 26Aug Bakery On O'Connell  North Ade,12.12,,671991.14,Food & Beverage,Food & Groceries
29/08/2024,Osko Withdrawal               29Aug21:09 Dean  & Colleen Littlefield,100,,672003.26,Withdrawals & Transfers,Withdrawal
29/08/2024,Osko Withdrawal               29Aug13:13 Kelly Deen,1900,,672103.26,Withdrawals & Transfers,Withdrawal
29/08/2024,Internet Withdrawal           29Aug06:01 To 1160084689040,800,,674003.26,Withdrawals & Transfers,Funds transfer
29/08/2024,Internet Withdrawal           29Aug06:01 To 802-919 001908567,1000,,674803.26,Withdrawals & Transfers,Funds transfer
29/08/2024,Osko Withdrawal               28Aug22:12 Hayley,1500,,675803.26,Withdrawals & Transfers,Withdrawal
27/08/2024,Visa Purchase                 24Aug Bakery On O'Connell  North Ade,12.63,,677303.26,Food & Beverage,Food & Groceries
26/08/2024,Visa Purchase                 23Aug City Bbq & Yum Cha P Rundle Ma,19.6,,677315.89,Food & Beverage,Dining out
26/08/2024,Visa Purchase                 23Aug City Cross Ezy Store Adelaide,10.4,,677335.49,Food & Beverage,Food & Groceries
26/08/2024,Cardless Atm Withdrawal       26Aug12:49 Rundle Place Os          Adelaide     Au,500,,677345.89,Withdrawals & Transfers,ATM & EFTPOS
23/08/2024,Visa Purchase                 20Aug Bakery On O'Connell  North Ade,19.19,,677845.89,Food & Beverage,Food & Groceries
23/08/2024,Visa Purchase                 20Aug Bakery On O'Connell  North Ade,18.18,,677865.08,Food & Beverage,Food & Groceries
23/08/2024,Visa Purchase                 21Aug Tea Tree Infinity Pt Adelaide,17.56,,677883.26,Food & Beverage,Dining out
23/08/2024,Internet Withdrawal           23Aug17:36 To 9000204517840,1000,,677900.82,Withdrawals & Transfers,Funds transfer
23/08/2024,Eftpos Debit                  23Aug09:31 Adobe\,43.99,,678900.82,Entertainment & Recreation,TV
22/08/2024,Visa Purchase                 19Aug T Phans Snack Bar    Adelaide,15.17,,678944.81,Food & Beverage,Dining out
22/08/2024,Internet Withdrawal           22Aug05:59 To 1160084689040,800,,678959.98,Withdrawals & Transfers,Funds transfer
22/08/2024,Internet Withdrawal           22Aug05:59 To 802-919 001908567,1000,,679759.98,Withdrawals & Transfers,Funds transfer
21/08/2024,Allianz Aust 1Rd221368016224234,172.39,,680759.98,Bills & Payments,Insurance
21/08/2024,Allianz Aust 1Rd220985016224234,23.13,,680932.37,Bills & Payments,Insurance
21/08/2024,Visa Purchase                 19Aug Google Youtube Membe Pyrmont,3.99,,680955.5,Entertainment & Recreation,TV
20/08/2024,Foreign Currency Conversn Fee,0.81,,680959.49,Fees & Charges,Fees & Charges
20/08/2024,Visa Purchase O/Seas          18Aug Usd18.00 Www.Downloadhelper.N,27.25,,680960.3,Entertainment & Recreation,TV
20/08/2024,Osko Withdrawal               20Aug21:10 Magda,1500,,680987.55,Withdrawals & Transfers,Withdrawal
19/08/2024,American Express 376012649071009,12444.97,,682487.55,Bills & Payments,Expenses & Payments
19/08/2024,Visa Purchase                 16Aug Kate Le Cong         Adelaide,61.25,,694932.52,Retail & Personal,Medical & Personal care
19/08/2024,Osko Withdrawal               19Aug12:07 Kelly Deen,1900,,694993.77,Withdrawals & Transfers,Withdrawal
17/08/2024,Visa Purchase                 15Aug City Bbq & Yum Cha P Rundle Ma,15.6,,696893.77,Food & Beverage,Dining out
17/08/2024,Visa Purchase                 15Aug Ccs Rundle Pty Ltd   Prospect,7,,696909.37,Food & Beverage,Food & Groceries
16/08/2024,Visa Purchase                 13Aug T Phans Snack Bar    Adelaide,11.12,,696916.37,Food & Beverage,Dining out
16/08/2024,Mcare Benefits 884149178 Gywq,,19.6,696927.49,Government payments,Centrelink payments
16/08/2024,Loan Repayment S.514.2655406.00,4924,,696907.89,Home & Property,Mortgage & Rent
16/08/2024,Osko Deposit                  15Aug22:18 Mrs Michelle Ann Muldoon,,250,701831.89,Deposits,Deposit
15/08/2024,Visa Purchase                 12Aug Hong Kong Grocery St Adelaide,15.8,,701581.89,Food & Beverage,Food & Groceries
15/08/2024,Visa Purchase                 12Aug Funk Adelaide Pty Lt Adelaide,6.5,,701597.69,Food & Beverage,Dining out
15/08/2024,Smith Partners R 005Nk7N Payment To,,1233.28,701604.19,Deposits,Deposit
15/08/2024,Australian Vapor Av Warranty,,744.95,700370.91,Deposits,Deposit
15/08/2024,Eftpos Debit                  15Aug11:45 Carina Pharmacy\,752.99,,699625.96,Retail & Personal,Medical & Personal care
15/08/2024,Internet Withdrawal           15Aug06:09 To 802-919 001908567,1000,,700378.95,Withdrawals & Transfers,Funds transfer
14/08/2024,Raa 35616154_11_1,78.58,,701378.95,Transport & Travel,Vehicle Expenses
14/08/2024,Visa Purchase                 11Aug Bakery On O'Connell  North Ade,30.81,,701457.53,Food & Beverage,Food & Groceries
14/08/2024,Internet Withdrawal           14Aug12:27 To 1160084689040,800,,701488.34,Withdrawals & Transfers,Funds transfer
13/08/2024,Visa Purchase                 12Aug Medibank Phi Debit   Melbourne,573.65,,702288.34,Bills & Payments,Insurance
13/08/2024,Visa Purchase                 09Aug Bakery On O'Connell  North Ade,15.15,,702861.99,Food & Beverage,Food & Groceries
12/08/2024,Visa Purchase                 09Aug Kate Le Cong         Adelaide,193.65,,702877.14,Retail & Personal,Medical & Personal care
12/08/2024,Visa Purchase                 09Aug Adelaide Discount Ph Adelaide,113.96,,703070.79,Retail & Personal,Medical & Personal care
12/08/2024,Osko Withdrawal               12Aug18:33 Ada,1500,,703184.75,Withdrawals & Transfers,Withdrawal
12/08/2024,Cardless Atm Withdrawal       12Aug15:08 Rundle Place Os          Adelaide     Au,500,,704684.75,Withdrawals & Transfers,ATM & EFTPOS
12/08/2024,Osko Withdrawal               12Aug15:33 Jodi Godby,500,,705184.75,Withdrawals & Transfers,Withdrawal
10/08/2024,Osko Withdrawal               10Aug19:22 Jodi Godby,500,,705684.75,Withdrawals & Transfers,Withdrawal
9/08/2024,Visa Purchase                 07Aug Tea Tree Infinity Pt Adelaide,17.56,,706184.75,Food & Beverage,Dining out
9/08/2024,Mcare Benefits 879150371 Gywq,,82.9,706202.31,Government payments,Centrelink payments
9/08/2024,Atm Withdrawal                09Aug17:55 Atmx 139 Oconnell St   North Adelaid08Au,1500,,706119.41,Withdrawals & Transfers,ATM & EFTPOS
8/08/2024,Internet Withdrawal           08Aug05:59 To 1160084689040,800,,707619.41,Withdrawals & Transfers,Funds transfer
8/08/2024,Internet Withdrawal           08Aug05:59 To 802-919 001908567,1000,,708419.41,Withdrawals & Transfers,Funds transfer
7/08/2024,Osko Withdrawal               07Aug20:59 Magda,700,,709419.41,Withdrawals & Transfers,Withdrawal
7/08/2024,Cardless Atm Withdrawal       07Aug13:24 Rundle Place Os          Adelaide     Au,500,,710119.41,Withdrawals & Transfers,ATM & EFTPOS
6/08/2024,Visa Purchase                 03Aug Bakery On O'Connell  North Ade,30.1,,710619.41,Food & Beverage,Food & Groceries
6/08/2024,Raa 37078205_2_1,22.25,,710649.51,Transport & Travel,Vehicle Expenses
5/08/2024,Visa Purchase                 01Aug Bakery On O'Connell  North Ade,18.18,,710671.76,Food & Beverage,Food & Groceries
5/08/2024,Osko Deposit                  05Aug18:18 Mrs Michelle Ann Muldoon,,250,710689.94,Deposits,Deposit
3/08/2024,Visa Purchase                 31Jul Yummy Tummy Food Bar Adelaide,18.7,,710439.94,Food & Beverage,Dining out
3/08/2024,Visa Purchase                 31Jul Bakery On O'Connell  North Ade,18.59,,710458.64,Food & Beverage,Food & Groceries
3/08/2024,Visa Purchase                 31Jul Bakery On O'Connell  North Ade,12.53,,710477.23,Food & Beverage,Food & Groceries
3/08/2024,Osko Deposit                  02Aug22:15 House Loan All Paid Thank You Mrs Michel,,50000,710489.76,Deposits,Deposit
2/08/2024,Visa Purchase                 30Jul Bakery On O'Connell  North Ade,12.12,,660489.76,Food & Beverage,Food & Groceries
1/08/2024,Visa Purchase                 30Jul Tea Tree Infinity Pt Adelaide,16.54,,660501.88,Food & Beverage,Dining out
1/08/2024,Osko Deposit                  01Aug22:07 Home Loan Home Loan Mrs Michelle Ann Mul,,50000,660518.42,Deposits,Deposit
1/08/2024,Osko Withdrawal               01Aug18:43 Magda,1500,,610518.42,Withdrawals & Transfers,Withdrawal
1/08/2024,Internet Withdrawal           01Aug06:16 To 1160084689040,800,,612018.42,Withdrawals & Transfers,Funds transfer
1/08/2024,Internet Withdrawal           01Aug06:16 To 802-919 001908567,1000,,612818.42,Withdrawals & Transfers,Funds transfer
31/07/2024,Visa Purchase                 28Jul Bakery On O'Connell  North Ade,30.61,,613818.42,Food & Beverage,Food & Groceries
31/07/2024,Smith Partners R 005Mgrz Payment To,,1255.28,613849.03,Deposits,Deposit
31/07/2024,Osko Withdrawal               31Jul14:07 Finley Greenhill Galea,500,,612593.75,Withdrawals & Transfers,Withdrawal
31/07/2024,Osko Withdrawal               31Jul13:58 Finley Greenhill Galea,1000,,613093.75,Withdrawals & Transfers,Withdrawal
31/07/2024,Internet Deposit              31Jul13:36 From 9000204517840,,12000,614093.75,Deposits,Deposit
31/07/2024,Internet Withdrawal           31Jul13:35 To 0280074830940,20000,,602093.75,Withdrawals & Transfers,Funds transfer
30/07/2024,Visa Purchase                 26Jul South Australian Wat Adelaide,357.59,,622093.75,Bills & Payments,Utilities & Rates
30/07/2024,Visa Purchase                 26Jul T Phans Snack Bar    Adelaide,15.67,,622451.34,Food & Beverage,Dining out
30/07/2024,Osko Withdrawal               30Jul11:38 Jc 1540 Payment For Services At Joe Cool,170.35,,622467.01,Withdrawals & Transfers,Withdrawal
29/07/2024,Raa 35878759_9_1,31.5,,622637.36,Transport & Travel,Vehicle Expenses
29/07/2024,Visa Purchase                 25Jul Bakery On O'Connell  North Ade,29.09,,622668.86,Food & Beverage,Food & Groceries
29/07/2024,Visa Purchase                 25Jul Tktx Australia       Kemps Cre,29,,622697.95,Retail & Personal,Retail (shopping)
29/07/2024,Raa 35676928_10_1,18.25,,622726.95,Transport & Travel,Vehicle Expenses
29/07/2024,Atm Withdrawal                29Jul20:24 Atmx 139 Oconnell St   North Adelaid08Au,2000,,622745.2,Withdrawals & Transfers,ATM & EFTPOS
29/07/2024,Osko Withdrawal               28Jul20:50 Ada,1400,,624745.2,Withdrawals & Transfers,Withdrawal
27/07/2024,Visa Purchase                 25Jul City Bbq & Yum Cha P Rundle Ma,21.6,,626145.2,Food & Beverage,Dining out
26/07/2024,Visa Purchase                 23Jul Hong Kong Grocery St Adelaide,19.39,,626166.8,Food & Beverage,Food & Groceries
26/07/2024,Visa Purchase                 23Jul Smp*The Flying Fig   North Ade,13.6,,626186.19,Food & Beverage,Food & Groceries
26/07/2024,Atm Withdrawal                26Jul15:05 Rundle Place Os          Adelaide     Au,500,,626199.79,Withdrawals & Transfers,ATM & EFTPOS
25/07/2024,Visa Purchase                 23Jul Koala Laptop Accesso Adelaide,100,,626699.79,Home & Property,Technology & Appliances
25/07/2024,Visa Purchase                 22Jul Bakery On O'Connell  North Ade,19.19,,626799.79,Food & Beverage,Food & Groceries
25/07/2024,Internet Withdrawal           25Jul06:01 To 1160084689040,800,,626818.98,Withdrawals & Transfers,Funds transfer
25/07/2024,Internet Withdrawal           25Jul06:01 To 802-919 001908567,1000,,627618.98,Withdrawals & Transfers,Funds transfer
24/07/2024,Osko Withdrawal               24Jul22:00 Kelly Deen,100,,628618.98,Withdrawals & Transfers,Withdrawal
24/07/2024,Osko Withdrawal               24Jul21:59 Kelly Deen,1800,,628718.98,Withdrawals & Transfers,Withdrawal
24/07/2024,Osko Withdrawal               24Jul16:01 Finley Greenhill Galea,400,,630518.98,Withdrawals & Transfers,Withdrawal
23/07/2024,Visa Purchase                 19Jul Bakery On O'Connell  North Ade,40.2,,630918.98,Food & Beverage,Food & Groceries
22/07/2024,Allianz Aust 1Rd221368013024204,172.39,,630959.18,Bills & Payments,Insurance
22/07/2024,Allianz Aust 1Rd220985013024204,23.13,,631131.57,Bills & Payments,Insurance
22/07/2024,Visa Purchase                 19Jul Google Youtube Membe Pyrmont,3.99,,631154.7,Entertainment & Recreation,TV
22/07/2024,Osko Withdrawal               22Jul13:45 Happy 30Tj Ada,1500,,631158.69,Withdrawals & Transfers,Withdrawal
22/07/2024,Osko Withdrawal               22Jul08:08 Hayley,1000,,632658.69,Withdrawals & Transfers,Withdrawal
22/07/2024,Osko Withdrawal               21Jul22:18 Finley Greenhill Galea,1500,,633658.69,Withdrawals & Transfers,Withdrawal
19/07/2024,American Express 376012649071009,9159.91,,635158.69,Bills & Payments,Expenses & Payments
19/07/2024,Cardless Atm Withdrawal       19Jul21:41 Rhodes Waterside Sc      Rhodes       Au,500,,644318.6,Withdrawals & Transfers,ATM & EFTPOS
19/07/2024,Osko Withdrawal               19Jul17:10 Sherryl Bhosekar,500,,644818.6,Withdrawals & Transfers,Withdrawal
19/07/2024,Atm Withdrawal                19Jul15:02 Atmx 139 Oconnell St   North Adelaid08Au,2000,,645318.6,Withdrawals & Transfers,ATM & EFTPOS
18/07/2024,Visa Purchase                 16Jul Koala Laptop Accesso Adelaide,2119,,647318.6,Home & Property,Technology & Appliances
18/07/2024,Visa Purchase                 16Jul Koala Laptop Accesso Adelaide,100,,649437.6,Home & Property,Technology & Appliances
18/07/2024,Visa Purchase                 14Jul Krung Thep           North Ade,79.28,,649537.6,Food & Beverage,Dining out
18/07/2024,Visa Purchase                 15Jul Bakery On O'Connell  North Ade,18.18,,649616.88,Food & Beverage,Food & Groceries
18/07/2024,Visa Purchase                 15Jul City Bbq & Yum Cha P Rundle Ma,16,,649635.06,Food & Beverage,Dining out
18/07/2024,Visa Purchase                 15Jul Bakery On O'Connell  North Ade,9.09,,649651.06,Food & Beverage,Food & Groceries
18/07/2024,Osko Deposit                  18Jul20:39 Mrs Michelle Ann Muldoon,,250,649660.15,Deposits,Deposit
18/07/2024,Internet Withdrawal           18Jul06:02 To 1160084689040,800,,649410.15,Withdrawals & Transfers,Funds transfer
18/07/2024,Internet Withdrawal           18Jul06:02 To 802-919 001908567,1000,,650210.15,Withdrawals & Transfers,Funds transfer
17/07/2024,Visa Purchase                 14Jul Bakery On O'Connell  North Ade,18.18,,651210.15,Food & Beverage,Food & Groceries
16/07/2024,Visa Purchase                 13Jul Sq *Village Asian Gr North Ade,26.2,,651228.33,Food & Beverage,Food & Groceries
16/07/2024,Visa Purchase                 13Jul Bakery On O'Connell  North Ade,12.12,,651254.53,Food & Beverage,Food & Groceries
16/07/2024,Osko Deposit                  16Jul19:52 Repay Tree Elizabeth Maul,,3500,651266.65,Deposits,Deposit
16/07/2024,Internet Withdrawal           16Jul19:10 To 1160084689040,100,,647766.65,Withdrawals & Transfers,Funds transfer
16/07/2024,Loan Repayment S.514.2655406.00,4924,,647866.65,Home & Property,Mortgage & Rent
16/07/2024,Smith Partners R 005Lj79 Payment To,,1255.28,652790.65,Deposits,Deposit
15/07/2024,Raa 35616154_10_1,78.58,,651535.37,Transport & Travel,Vehicle Expenses
15/07/2024,Visa Purchase                 12Jul City Bbq & Yum Cha P Rundle Ma,16.3,,651613.95,Food & Beverage,Dining out
15/07/2024,Osko Withdrawal               14Jul22:22 Magda,1000,,651630.25,Withdrawals & Transfers,Withdrawal
13/07/2024,Visa Purchase                 11Jul Rotary Club Of Burns Wattle Pa,3.5,,652630.25,Food & Beverage,Dining out
13/07/2024,Osko Withdrawal               13Jul19:58 Bradley Parkinson,350,,652633.75,Withdrawals & Transfers,Withdrawal
12/07/2024,Visa Purchase                 08Jul Epoch.Com   *Tecomlt Limassol,85.97,,652983.75,Retail & Personal,Retail (shopping)
12/07/2024,Osko Deposit                  12Jul17:27 Loan Thanks Mrs Michelle Ann Muldoon,,250,653069.72,Deposits,Deposit
11/07/2024,Visa Purchase                 10Jul Medibank Phi Debit   Melbourne,573.65,,652819.72,Bills & Payments,Insurance
11/07/2024,Visa Purchase                 09Jul Tea Tree Infinity Pt Adelaide,16.54,,653393.37,Food & Beverage,Dining out
11/07/2024,Osko Withdrawal               11Jul09:09 178757 For Order Number 178757 Ozsmoke,226.62,,653409.91,Withdrawals & Transfers,Withdrawal
11/07/2024,Internet Withdrawal           11Jul09:08 To 0280074830940,3000,,653636.53,Withdrawals & Transfers,Funds transfer
11/07/2024,Internet Withdrawal           11Jul05:59 To 1160084689040,800,,656636.53,Withdrawals & Transfers,Funds transfer
11/07/2024,Internet Withdrawal           11Jul05:59 To 802-919 001908567,1000,,657436.53,Withdrawals & Transfers,Funds transfer
10/07/2024,Visa Purchase                 07Jul Bakery On O'Connell  North Ade,34.55,,658436.53,Food & Beverage,Food & Groceries
9/07/2024,Visa Purchase                 06Jul Bakery On O'Connell  North Ade,24.44,,658471.08,Food & Beverage,Food & Groceries
9/07/2024,Osko Withdrawal               09Jul13:37 Kelly Deen,2000,,658495.52,Withdrawals & Transfers,Withdrawal
8/07/2024,Foreign Currency Conversn Fee,1.81,,660495.52,Fees & Charges,Fees & Charges
8/07/2024,Visa Purchase O/Seas          06Jul Usd40.63 Fw* Kyle Hill,60.56,,660497.33,Retail & Personal,Clothing & Shoes
8/07/2024,Visa Purchase                 04Jul Zlr*Metropolitan Fre North Ade,58.66,,660557.89,Food & Beverage,Food & Groceries
8/07/2024,Raa 37078205_1_1,22.25,,660616.55,Transport & Travel,Vehicle Expenses
8/07/2024,Internet Withdrawal           08Jul11:04 To 1160084689040,700,,660638.8,Withdrawals & Transfers,Funds transfer
8/07/2024,Internet Withdrawal           08Jul10:41 To 1160084689040,100,,661338.8,Withdrawals & Transfers,Funds transfer
8/07/2024,Internet Withdrawal           07Jul21:47 To 1160084689040,50,,661438.8,Withdrawals & Transfers,Funds transfer
6/07/2024,Osko Deposit                  06Jul18:18 Mrs Michelle Ann Muldoon,,1150,661488.8,Deposits,Deposit
4/07/2024,Internet Withdrawal           04Jul06:02 To 802-919 001908567,1000,,660338.8,Withdrawals & Transfers,Funds transfer
3/07/2024,Internet Withdrawal           03Jul16:43 To 1160084689040,800,,661338.8,Withdrawals & Transfers,Funds transfer
3/07/2024,Osko Withdrawal               03Jul00:59 Ada,1400,,662138.8,Withdrawals & Transfers,Withdrawal
2/07/2024,Visa Purchase                 29Jun Bakery On O'Connell  North Ade,21.92,,663538.8,Food & Beverage,Food & Groceries
2/07/2024,Visa Purchase                 29Jun North Adelaide News  North Ade,2.59,,663560.72,Entertainment & Recreation,Books & Subscriptions
2/07/2024,Eftpos Debit                  02Jul20:04 Beem\\Db1A3679601A480Cb1Cb5Eb7365594Fc,50,,663563.31,Withdrawals & Transfers,Funds transfer
1/07/2024,Raa 35878759_8_1,31.5,,663613.31,Transport & Travel,Vehicle Expenses
1/07/2024,Raa 35676928_9_1,18.25,,663644.81,Transport & Travel,Vehicle Expenses
1/07/2024,Visa Purchase                 28Jun Tea Tree Infinity Pt Adelaide,16.54,,663663.06,Food & Beverage,Dining out
1/07/2024,Property Managme Rent,,1199.9,663679.6,Deposits,Deposit
1/07/2024,Eftpos Debit                  30Jun10:42 Beem\\6Da119Ab92Cf45Bca29Dafd3Aa4E28Db,2000,,662479.7,Withdrawals & Transfers,Funds transfer
29/06/2024,Visa Purchase                 26Jun T Phans Snack Bar    Adelaide,14.66,,664479.7,Food & Beverage,Dining out
29/06/2024,Internet Withdrawal           29Jun14:15 To 1160084689040,800,,664494.36,Withdrawals & Transfers,Funds transfer
29/06/2024,Osko Deposit                  29Jun04:44 Thanks Me  Mrs Michelle Ann Muldoon,,250,665294.36,Deposits,Deposit
28/06/2024,Visa Purchase                 26Jun Huynh Luan Tan       Ashford,495.2,,665044.36,Retail & Personal,Medical & Personal care
28/06/2024,Visa Purchase                 25Jun Bakery On O'Connell  North Ade,12.32,,665539.56,Food & Beverage,Food & Groceries
28/06/2024,Atm Withdrawal                28Jun11:45 Rundle Place Os          Adelaide     Au,2000,,665551.88,Withdrawals & Transfers,ATM & EFTPOS
27/06/2024,Visa Purchase                 24Jun Bakery On O'Connell  North Ade,23.23,,667551.88,Food & Beverage,Food & Groceries
27/06/2024,Visa Purchase                 24Jun T Phans Snack Bar    Adelaide,10.11,,667575.11,Food & Beverage,Dining out
27/06/2024,Internet Withdrawal           27Jun06:01 To 0280074830940,802.35,,667585.22,Withdrawals & Transfers,Funds transfer
27/06/2024,Internet Withdrawal           27Jun06:01 To 802-919 001908567,1000,,668387.57,Withdrawals & Transfers,Funds transfer
27/06/2024,Internet Withdrawal           27Jun06:01 To 1160084689040,802.35,,669387.57,Withdrawals & Transfers,Funds transfer
26/06/2024,Tfr Wdl BPAY Internet         26Jun09:18 111534              City Of Adelaide,688.2,,670189.92,Bills & Payments,Tax payments
25/06/2024,Visa Purchase                 22Jun Zlr*Metropolitan Fre North Ade,22.88,,670878.12,Food & Beverage,Food & Groceries
25/06/2024,Visa Purchase                 22Jun North Adelaide News  North Ade,20.9,,670901,Entertainment & Recreation,Books & Subscriptions
22/06/2024,Visa Purchase                 20Jun National Pharmacies  North Ade,56.98,,670921.9,Retail & Personal,Medical & Personal care
22/06/2024,Visa Purchase                 20Jun City Bbq & Yum Cha P Rundle Ma,13.5,,670978.88,Food & Beverage,Dining out
22/06/2024,Eftpos Debit                  22Jun19:41 Beem\\717291Db5Acb4A42B39393B97E32D856,50,,670992.38,Withdrawals & Transfers,Funds transfer
21/06/2024,Allianz Aust 1Rd221368019124173,172.39,,671042.38,Bills & Payments,Insurance
21/06/2024,Allianz Aust 1Rd220985019124173,23.13,,671214.77,Bills & Payments,Insurance
21/06/2024,Eftpos Debit                  21Jun11:20 Beem\\B8A50B9201764Feca95947D86333Fd09,350,,671237.9,Withdrawals & Transfers,Funds transfer
20/06/2024,Visa Purchase                 17Jun The Garage Door Guys Totness,2095,,671587.9,Home & Property,Services & Tradespeople
20/06/2024,Cash Withdrawal,7000,,673682.9,Withdrawals & Transfers,Withdrawal
20/06/2024,Internet Deposit              20Jun10:46 From 1160084689040,,2000,680682.9,Deposits,Deposit
20/06/2024,Internet Withdrawal           20Jun06:03 To 0280074830940,802.35,,678682.9,Withdrawals & Transfers,Funds transfer
20/06/2024,Internet Withdrawal           20Jun06:03 To 802-919 001908567,1000,,679485.25,Withdrawals & Transfers,Funds transfer
20/06/2024,Internet Withdrawal           20Jun06:03 To 1160084689040,802.35,,680485.25,Withdrawals & Transfers,Funds transfer
19/06/2024,Visa Purchase                 16Jun Bakery On O'Connell  North Ade,17.68,,681287.6,Food & Beverage,Food & Groceries
19/06/2024,Visa Purchase                 17Jun Ndc Service Co Pty L North Ade,5.6,,681305.28,Retail & Personal,Medical & Personal care
19/06/2024,Property Managme Rent,,1199.9,681310.88,Deposits,Deposit
19/06/2024,Osko Withdrawal               19Jun18:58 Hayley,500,,680110.98,Withdrawals & Transfers,Withdrawal
18/06/2024,Visa Purchase                 16Jun Sq *Adelaide Physica Adelaide,3.5,,680610.98,Entertainment & Recreation,Sports & Leisure
18/06/2024,Cardless Atm Withdrawal       18Jun15:25 Rundle Place Os          Adelaide     Au,500,,680614.48,Withdrawals & Transfers,ATM & EFTPOS
18/06/2024,Osko Withdrawal               18Jun14:05 Liz,3500,,681114.48,Withdrawals & Transfers,Withdrawal
18/06/2024,Osko Withdrawal               18Jun13:03 Kelly Deen,1000,,684614.48,Withdrawals & Transfers,Withdrawal
17/06/2024,Loan Repayment S.514.2655406.00,4924,,685614.48,Home & Property,Mortgage & Rent
17/06/2024,Eftpos Debit                  16Jun06:52 Beem\\C6Dbb2C135Db4F7692454Eb820E76Ff3,500,,690538.48,Withdrawals & Transfers,Funds transfer
15/06/2024,Visa Purchase                 12Jun Wink Wealth Pty L Td Frenchs F,52.92,,691038.48,Entertainment & Recreation,TV
15/06/2024,Internet Withdrawal           15Jun16:41 To 1160084689040,1400,,691091.4,Withdrawals & Transfers,Funds transfer
14/06/2024,Raa 35616154_9_1,78.58,,692491.4,Transport & Travel,Vehicle Expenses
14/06/2024,Visa Purchase                 11Jun Smp*Stirling  Chicke Stirling,36.8,,692569.98,Food & Beverage,Dining out
14/06/2024,Visa Purchase                 12Jun City Bbq & Yum Cha P Rundle Ma,17.6,,692606.78,Food & Beverage,Dining out
13/06/2024,Visa Purchase                 10Jun Bakery On O'Connell  North Ade,16.97,,692624.38,Food & Beverage,Food & Groceries
13/06/2024,Internet Withdrawal           13Jun06:00 To 0280074830940,802.35,,692641.35,Withdrawals & Transfers,Funds transfer
13/06/2024,Internet Withdrawal           13Jun06:00 To 802-919 001908567,1000,,693443.7,Withdrawals & Transfers,Funds transfer
13/06/2024,Internet Withdrawal           13Jun06:00 To 1160084689040,802.35,,694443.7,Withdrawals & Transfers,Funds transfer
12/06/2024,Cardless Atm Withdrawal       12Jun12:01 Rundle Place Os          Adelaide     Au,500,,695246.05,Withdrawals & Transfers,ATM & EFTPOS
11/06/2024,Visa Purchase                 10Jun Medibank Phi Debit   Melbourne,573.65,,695746.05,Bills & Payments,Insurance
11/06/2024,Foreign Currency Conversn Fee,1.25,,696319.7,Fees & Charges,Fees & Charges
11/06/2024,Visa Purchase O/Seas          08Jun Usd27.49 Select Media,41.81,,696320.95,Retail & Personal,Retail (shopping)
11/06/2024,Osko Withdrawal               11Jun14:59 Kelly Deen,1100,,696362.76,Withdrawals & Transfers,Withdrawal
10/06/2024,Visa Purchase                 06Jun T Phans Snack Bar    Adelaide,19.21,,697462.76,Food & Beverage,Dining out
8/06/2024,Eftpos Debit                  08Jun21:53 Beem\\919625Dd1Ab3422B873A2Ffb00E2A083,1400,,697481.97,Withdrawals & Transfers,Funds transfer
6/06/2024,Raa 35036678_12_1,20.08,,698881.97,Transport & Travel,Vehicle Expenses
6/06/2024,Visa Purchase                 04Jun Tea Tree Infinity Pt Adelaide,16.54,,698902.05,Food & Beverage,Dining out
6/06/2024,Osko Deposit                  06Jun17:31 Mrs Michelle Ann Russell,,250,698918.59,Deposits,Deposit
6/06/2024,Internet Withdrawal           06Jun06:04 To 0280074830940,802.35,,698668.59,Withdrawals & Transfers,Funds transfer
6/06/2024,Internet Withdrawal           06Jun06:04 To 802-919 001908567,1000,,699470.94,Withdrawals & Transfers,Funds transfer
6/06/2024,Internet Withdrawal           06Jun06:04 To 1160084689040,802.35,,700470.94,Withdrawals & Transfers,Funds transfer
4/06/2024,Cardless Atm Withdrawal       04Jun12:05 Rundle Place Os          Adelaide     Au,500,,701273.29,Withdrawals & Transfers,ATM & EFTPOS
3/06/2024,American Express 376012649071009,9147.37,,701773.29,Bills & Payments,Expenses & Payments
3/06/2024,Osko Deposit                  03Jun14:36 Money Lucas Chapman,,175,710920.66,Deposits,Deposit
3/06/2024,Osko Withdrawal               02Jun21:06 Magda,2900,,710745.66,Withdrawals & Transfers,Withdrawal
1/06/2024,Visa Purchase                 29May Bakers Delight       North Ade,3.5,,713645.66,Food & Beverage,Food & Groceries
31/05/2024,Property Managme Rent,,1177.9,713649.16,Deposits,Deposit
30/05/2024,Visa Purchase                 28May City Bbq & Yum Cha P Rundle Ma,11,,712471.26,Food & Beverage,Dining out
30/05/2024,Internet Withdrawal           30May06:01 To 0280074830940,802.35,,712482.26,Withdrawals & Transfers,Funds transfer
30/05/2024,Internet Withdrawal           30May06:01 To 802-919 001908567,1000,,713284.61,Withdrawals & Transfers,Funds transfer
30/05/2024,Internet Withdrawal           30May06:01 To 1160084689040,802.35,,714284.61,Withdrawals & Transfers,Funds transfer
29/05/2024,Visa Purchase                 27May Kate Le Cong         Adelaide,171.35,,715086.96,Retail & Personal,Medical & Personal care
29/05/2024,Raa 35878759_7_1,31.5,,715258.31,Transport & Travel,Vehicle Expenses
29/05/2024,Visa Purchase                 26May Jeff Ramsey Pharmaci North Ade,27.96,,715289.81,Retail & Personal,Medical & Personal care
29/05/2024,Raa 35676928_8_1,18.25,,715317.77,Transport & Travel,Vehicle Expenses
28/05/2024,Visa Purchase                 26May Zlr*Metropolitan Fre North Ade,40.27,,715336.02,Food & Beverage,Food & Groceries
28/05/2024,Visa Purchase                 25May Bakery On O'Connell  North Ade,11.11,,715376.29,Food & Beverage,Food & Groceries
28/05/2024,Cardless Atm Withdrawal       28May15:42 Rundle Place Os          Adelaide     Au,250,,715387.4,Withdrawals & Transfers,ATM & EFTPOS
27/05/2024,Visa Purchase                 23May Chicken Villa - Seaf West Beac,52.94,,715637.4,Food & Beverage,Dining out
27/05/2024,Visa Purchase                 24May City Bbq & Yum Cha P Rundle Ma,19.6,,715690.34,Food & Beverage,Dining out
27/05/2024,Visa Purchase                 23May Chicken Villa - Seaf West Beac,9.18,,715709.94,Food & Beverage,Dining out
27/05/2024,Mcare Benefits 825172162 Gywq,,80.1,715719.12,Government payments,Centrelink payments
25/05/2024,Osko Withdrawal               25May16:42 Hayley,1000,,715639.02,Withdrawals & Transfers,Withdrawal
24/05/2024,Internet Withdrawal           24May17:34 To 1160084689040,1400,,716639.02,Withdrawals & Transfers,Funds transfer
24/05/2024,Atm Withdrawal                24May11:39 Rundle Place Os          Adelaide     Au,1000,,718039.02,Withdrawals & Transfers,ATM & EFTPOS
23/05/2024,Visa Purchase                 20May City Bbq & Yum Cha P Rundle Ma,19.6,,719039.02,Food & Beverage,Dining out
23/05/2024,Visa Purchase                 21May Ls Perrymans Bakery  North Ade,10.2,,719058.62,Food & Beverage,Food & Groceries
23/05/2024,Internet Withdrawal           23May06:03 To 1160084689040,500,,719068.82,Withdrawals & Transfers,Funds transfer
23/05/2024,Internet Withdrawal           23May06:03 To 0280074830940,802.35,,719568.82,Withdrawals & Transfers,Funds transfer
23/05/2024,Internet Withdrawal           23May06:03 To 802-919 001908567,1000,,720371.17,Withdrawals & Transfers,Funds transfer
23/05/2024,Internet Withdrawal           23May06:03 To 1160084689040,802.35,,721371.17,Withdrawals & Transfers,Funds transfer
22/05/2024,Visa Purchase                 20May Smokoz               Adelaide,14.5,,722173.52,Food & Beverage,Food & Groceries
22/05/2024,Visa Purchase                 19May Uber   *One          Sydney,9.99,,722188.02,Transport & Travel,Taxi & Rental car
21/05/2024,Allianz Aust 1Rd221368015724142,172.39,,722198.01,Bills & Payments,Insurance
21/05/2024,Allianz Aust 1Rd220985015724142,23.13,,722370.4,Bills & Payments,Insurance
21/05/2024,Atm Withdrawal                21May15:40 Atmx 139 Oconnell St   North Adelaid08Au,500,,722393.53,Withdrawals & Transfers,ATM & EFTPOS
21/05/2024,Osko Deposit                  21May15:52 Thank You  Alexsandra Panagopoulos,,3500,722893.53,Deposits,Deposit
21/05/2024,Osko Withdrawal               21May15:25 Magda,5000,,719393.53,Withdrawals & Transfers,Withdrawal
20/05/2024,Cardless Atm Withdrawal       20May11:35 Rundle Place Os          Adelaide     Au,500,,724393.53,Withdrawals & Transfers,ATM & EFTPOS
18/05/2024,Visa Purchase                 16May Brighton & Seacliff  Seacliff,19.5,,724893.53,Food & Beverage,Dining out
17/05/2024,American Express 376012649071009,30415.84,,724913.03,Bills & Payments,Expenses & Payments
17/05/2024,Internet Withdrawal           17May16:08 To 1160084689040,1450,,755328.87,Withdrawals & Transfers,Funds transfer
17/05/2024,Atm Withdrawal                17May12:10 Atmx 139 Oconnell St   North Adelaid08Au,2000,,756778.87,Withdrawals & Transfers,ATM & EFTPOS
16/05/2024,Foreign Currency Conversn Fee,7.52,,758778.87,Fees & Charges,Fees & Charges
16/05/2024,Visa Purchase O/Seas          15May Usd165.00 Select Media,250.84,,758786.39,Retail & Personal,Retail (shopping)
16/05/2024,Foreign Currency Conversn Fee,4.01,,759037.23,Fees & Charges,Fees & Charges
16/05/2024,Visa Purchase O/Seas          15May Usd88.00 Select Media,133.78,,759041.24,Retail & Personal,Retail (shopping)
16/05/2024,Foreign Currency Conversn Fee,2.5,,759175.02,Fees & Charges,Fees & Charges
16/05/2024,Visa Purchase O/Seas          15May Usd55.00 Select Media,83.61,,759177.52,Retail & Personal,Retail (shopping)
16/05/2024,Foreign Currency Conversn Fee,1.25,,759261.13,Fees & Charges,Fees & Charges
16/05/2024,Visa Purchase O/Seas          15May Usd27.50 Select Media,41.81,,759262.38,Retail & Personal,Retail (shopping)
16/05/2024,Visa Purchase                 13May Bakery On O'Connell  North Ade,6.06,,759304.19,Food & Beverage,Food & Groceries
16/05/2024,Loan Repayment S.514.2655406.00,4924,,759310.25,Home & Property,Mortgage & Rent
16/05/2024,Internet Withdrawal           16May06:03 To 0280074830940,802.35,,764234.25,Withdrawals & Transfers,Funds transfer
16/05/2024,Internet Withdrawal           16May06:03 To 802-919 001908567,1000,,765036.6,Withdrawals & Transfers,Funds transfer
16/05/2024,Internet Withdrawal           16May06:03 To 1160084689040,802.35,,766036.6,Withdrawals & Transfers,Funds transfer
15/05/2024,Visa Purchase                 13May Bakers Delight       North Ade,3.5,,766838.95,Food & Beverage,Food & Groceries
15/05/2024,Visa Purchase                 12May Bakers Delight       North Ade,3.5,,766842.45,Food & Beverage,Food & Groceries
15/05/2024,Property Managme Rent,,451.9,766845.95,Deposits,Deposit
15/05/2024,Osko Deposit                  15May17:14 Antion Muldoon,,300,766394.05,Deposits,Deposit
14/05/2024,Raa 35616154_8_1,78.58,,766094.05,Transport & Travel,Vehicle Expenses
14/05/2024,Visa Purchase                 10May T Phans Snack Bar    Adelaide,14.66,,766172.63,Food & Beverage,Dining out
14/05/2024,Foreign Currency Conversn Fee,0.4,,766187.29,Fees & Charges,Fees & Charges
14/05/2024,Visa Purchase O/Seas          11May Usd8.80 Select Media,13.35,,766187.69,Retail & Personal,Retail (shopping)
14/05/2024,Cardless Atm Withdrawal       14May13:18 Rundle Place Os          Adelaide     Au,500,,766201.04,Withdrawals & Transfers,ATM & EFTPOS
13/05/2024,Foreign Currency Conversn Fee,0.5,,766701.04,Fees & Charges,Fees & Charges
13/05/2024,Visa Purchase O/Seas          10May Usd10.99 Select Media Llc,16.76,,766701.54,Retail & Personal,Retail (shopping)
13/05/2024,Rtgs Inward Payment Sgb2405130318062St James Place Intl,,350000,766718.3,Deposits,Deposit
11/05/2024,Visa Purchase                 10May Medibank Phi Debit   Melbourne,573.65,,416718.3,Bills & Payments,Insurance
11/05/2024,Foreign Currency Conversn Fee,3.77,,417291.95,Fees & Charges,Fees & Charges
11/05/2024,Visa Purchase O/Seas          09May Usd82.50 Select Media,125.84,,417295.72,Retail & Personal,Retail (shopping)
11/05/2024,Visa Purchase                 08May Smp*The Flying Fig   North Ade,61.1,,417421.56,Food & Beverage,Food & Groceries
11/05/2024,Foreign Currency Conversn Fee,1,,417482.66,Fees & Charges,Fees & Charges
11/05/2024,Visa Purchase O/Seas          09May Usd22.00 Select Media,33.56,,417483.66,Retail & Personal,Retail (shopping)
11/05/2024,Foreign Currency Conversn Fee,1,,417517.22,Fees & Charges,Fees & Charges
11/05/2024,Visa Purchase O/Seas          09May Usd22.00 Select Media,33.56,,417518.22,Retail & Personal,Retail (shopping)
11/05/2024,Foreign Currency Conversn Fee,0.5,,417551.78,Fees & Charges,Fees & Charges
11/05/2024,Visa Purchase O/Seas          09May Usd11.00 Select Media,16.78,,417552.28,Retail & Personal,Retail (shopping)
11/05/2024,Eftpos Debit                  11May15:43 Beem\\Bb6822Daf8974Ab9810Aeba16D44Ea47,450,,417569.06,Withdrawals & Transfers,Funds transfer
10/05/2024,Cardless Atm Withdrawal       10May12:44 Rundle Place Os          Adelaide     Au,500,,418019.06,Withdrawals & Transfers,ATM & EFTPOS
9/05/2024,Osko Withdrawal               09May13:38 Kelly Deen,200,,418519.06,Withdrawals & Transfers,Withdrawal
9/05/2024,Osko Withdrawal               09May13:36 Kelly Deen,1900,,418719.06,Withdrawals & Transfers,Withdrawal
9/05/2024,Internet Withdrawal           09May06:03 To 1160084689040,500,,420619.06,Withdrawals & Transfers,Funds transfer
9/05/2024,Internet Withdrawal           09May06:03 To 0280074830940,802.35,,421119.06,Withdrawals & Transfers,Funds transfer
9/05/2024,Internet Withdrawal           09May06:03 To 802-919 001908567,1000,,421921.41,Withdrawals & Transfers,Funds transfer
9/05/2024,Internet Withdrawal           09May06:03 To 1160084689040,802.35,,422921.41,Withdrawals & Transfers,Funds transfer
8/05/2024,Visa Purchase                 06May Tea Tree Infinity Pt Adelaide,20.4,,423723.76,Food & Beverage,Dining out
7/05/2024,Visa Purchase                 04May Bakery On O'Connell  North Ade,21.01,,423744.16,Food & Beverage,Food & Groceries
7/05/2024,Osko Deposit                  07May10:27 Antion Muldoon,,400,423765.17,Deposits,Deposit
6/05/2024,Raa 35036678_11_1,20.08,,423365.17,Transport & Travel,Vehicle Expenses
6/05/2024,Atm Withdrawal                06May16:28 Atmx 139 Oconnell St   North Adelaid08Au,1000,,423385.25,Withdrawals & Transfers,ATM & EFTPOS
4/05/2024,Visa Purchase                 01May Hungry Jacks         Glen Osmo,15.3,,424385.25,Food & Beverage,Dining out
2/05/2024,Internet Withdrawal           02May06:02 To 0280074830940,802.35,,424400.55,Withdrawals & Transfers,Funds transfer
2/05/2024,Internet Withdrawal           02May06:02 To 802-919 001908567,1000,,425202.9,Withdrawals & Transfers,Funds transfer
2/05/2024,Internet Withdrawal           02May06:02 To 1160084689040,802.35,,426202.9,Withdrawals & Transfers,Funds transfer
1/05/2024,Property Managme Rent,,1274.1,427005.25,Deposits,Deposit
1/05/2024,Osko Deposit                  01May08:59 Mrs Michelle Ann Russell,,3000,425731.15,Deposits,Deposit
30/04/2024,Overseas Withdrawal Fee,5,,422731.15,Fees & Charges,Fees & Charges
30/04/2024,Atm Withdrawal                30Apr15:16 Rundle Place Os          Adelaide     Au,150,,422736.15,Withdrawals & Transfers,ATM & EFTPOS
29/04/2024,Visa Purchase                 25Apr South Australian Wat Adelaide,405.46,,422886.15,Bills & Payments,Utilities & Rates
29/04/2024,Raa 35878759_6_1,31.5,,423291.61,Transport & Travel,Vehicle Expenses
29/04/2024,Raa 35676928_7_1,18.25,,423323.11,Transport & Travel,Vehicle Expenses
29/04/2024,Osko Withdrawal               28Apr14:31 Magda,1000,,423341.36,Withdrawals & Transfers,Withdrawal
27/04/2024,Visa Purchase                 23Apr City Bbq & Yum Cha P Rundle Ma,24.1,,424341.36,Food & Beverage,Dining out
27/04/2024,Visa Purchase                 24Apr Sq *Village Asian Gr North Ade,14.68,,424365.46,Food & Beverage,Food & Groceries
27/04/2024,Osko Withdrawal               27Apr15:07 K Bond,500,,424380.14,Withdrawals & Transfers,Withdrawal
27/04/2024,Osko Withdrawal               27Apr15:06 Andrew Maul,1500,,424880.14,Withdrawals & Transfers,Withdrawal
27/04/2024,Cardless Atm Withdrawal       27Apr14:42 Westpac               Chirnside Pk 3  Au,500,,426380.14,Withdrawals & Transfers,ATM & EFTPOS
27/04/2024,Osko Withdrawal               27Apr11:39 Andrew Maul,100,,426880.14,Withdrawals & Transfers,Withdrawal
27/04/2024,Osko Withdrawal               27Apr10:20 Kelly Deen,1900,,426980.14,Withdrawals & Transfers,Withdrawal
26/04/2024,Osko Withdrawal               25Apr19:50 Andrew Maul,400,,428880.14,Withdrawals & Transfers,Withdrawal
26/04/2024,Internet Withdrawal           25Apr06:03 To 1160084689040,500,,429280.14,Withdrawals & Transfers,Funds transfer
26/04/2024,Internet Withdrawal           25Apr06:03 To 0280074830940,802.35,,429780.14,Withdrawals & Transfers,Funds transfer
26/04/2024,Internet Withdrawal           25Apr06:03 To 802-919 001908567,1000,,430582.49,Withdrawals & Transfers,Funds transfer
26/04/2024,Internet Withdrawal           25Apr06:03 To 1160084689040,802.35,,431582.49,Withdrawals & Transfers,Funds transfer
24/04/2024,Visa Purchase                 21Apr Mr Rhino Supermarket Melbourne,6.09,,432384.84,Food & Beverage,Food & Groceries
24/04/2024,Atm Withdrawal                24Apr16:21 Atmx 139 Oconnell St   North Adelaid08Au,2000,,432390.93,Withdrawals & Transfers,ATM & EFTPOS
23/04/2024,Visa Purchase                 20Apr Hongyun Foods Pty Lt Melbourne,29.29,,434390.93,Food & Beverage,Dining out
23/04/2024,Osko Withdrawal               23Apr21:03 Magda,300,,434420.22,Withdrawals & Transfers,Withdrawal
23/04/2024,Cardless Atm Withdrawal       23Apr12:42 Rundle Place Os          Adelaide     Au,500,,434720.22,Withdrawals & Transfers,ATM & EFTPOS
22/04/2024,Allianz Aust 1Rd221368012624113,172.39,,435220.22,Bills & Payments,Insurance
22/04/2024,Allianz Aust 1Rd220985012624113,23.13,,435392.61,Bills & Payments,Insurance
22/04/2024,Osko Withdrawal               22Apr14:53 Andrew Maul,300,,435415.74,Withdrawals & Transfers,Withdrawal
22/04/2024,Osko Withdrawal               21Apr21:41 Andrew Maul,500,,435715.74,Withdrawals & Transfers,Withdrawal
19/04/2024,Visa Purchase                 16Apr Bakery On O'Connell  North Ade,5.86,,436215.74,Food & Beverage,Food & Groceries
19/04/2024,Internet Withdrawal           19Apr06:02 To 0280074830940,802.35,,436221.6,Withdrawals & Transfers,Funds transfer
19/04/2024,Internet Withdrawal           19Apr06:02 To 802-919 001908567,1000,,437023.95,Withdrawals & Transfers,Funds transfer
18/04/2024,Visa Purchase                 15Apr Uber   *One          Sydney,9.99,,438023.95,Transport & Travel,Taxi & Rental car
18/04/2024,Osko Withdrawal               18Apr16:08 Superhero,1000,,438033.94,Withdrawals & Transfers,Withdrawal
18/04/2024,Internet Withdrawal           18Apr06:01 To 1160084689040,802.35,,439033.94,Withdrawals & Transfers,Funds transfer
17/04/2024,Visa Purchase                 15Apr Fancy Dumplings      Adelaide,10,,439836.29,Food & Beverage,Dining out
17/04/2024,Visa Purchase                 15Apr Bakers Delight       North Ade,3.5,,439846.29,Food & Beverage,Food & Groceries
16/04/2024,Loan Repayment S.514.2655406.00,4924,,439849.79,Home & Property,Mortgage & Rent
16/04/2024,Atm Withdrawal                16Apr15:25 Atmx 139 Oconnell St   North Adelaid08Au,2000,,444773.79,Withdrawals & Transfers,ATM & EFTPOS
15/04/2024,American Express 376012649071009,25594.51,,446773.79,Bills & Payments,Expenses & Payments
15/04/2024,Raa 35616154_7_1,78.58,,472368.3,Transport & Travel,Vehicle Expenses
15/04/2024,Property Managme Rent,,2399.8,472446.88,Deposits,Deposit
15/04/2024,Osko Withdrawal               15Apr14:26 Finley Greenhill Galea,1300,,470047.08,Withdrawals & Transfers,Withdrawal
15/04/2024,Osko Withdrawal               14Apr14:38 M  Nour,1000,,471347.08,Withdrawals & Transfers,Withdrawal
13/04/2024,Osko Withdrawal               13Apr15:58 J T Smith,399,,472347.08,Withdrawals & Transfers,Withdrawal
13/04/2024,Osko Withdrawal               13Apr01:20 Js,300,,472746.08,Withdrawals & Transfers,Withdrawal
13/04/2024,Osko Withdrawal               12Apr23:15 J T Smith,1200,,473046.08,Withdrawals & Transfers,Withdrawal
13/04/2024,Osko Withdrawal               12Apr23:13 M Marol,130,,474246.08,Withdrawals & Transfers,Withdrawal
12/04/2024,Visa Purchase                 08Apr Epoch  *Tecomltd     Limassol,85.97,,474376.08,Retail & Personal,Retail (shopping)
12/04/2024,Osko Withdrawal               12Apr21:39 M Kovacevic,200,,474462.05,Withdrawals & Transfers,Withdrawal
12/04/2024,Osko Withdrawal               12Apr19:23 Kelly Deen,1000,,474662.05,Withdrawals & Transfers,Withdrawal
12/04/2024,Osko Withdrawal               12Apr09:04 Superhero,1000,,475662.05,Withdrawals & Transfers,Withdrawal
12/04/2024,Internet Withdrawal           12Apr06:04 To 0280074830940,802.35,,476662.05,Withdrawals & Transfers,Funds transfer
12/04/2024,Internet Withdrawal           12Apr06:04 To 802-919 001908567,1000,,477464.4,Withdrawals & Transfers,Funds transfer
11/04/2024,Visa Purchase                 10Apr Medibank Phi Debit   Melbourne,571.55,,478464.4,Bills & Payments,Insurance
11/04/2024,Visa Purchase                 09Apr Just Guys Sa Pty Ltd Adelaide,55,,479035.95,Retail & Personal,Retail (shopping)
11/04/2024,Visa Purchase                 09Apr Zlr*Warong Rundle    Adelaide,19.16,,479090.95,Food & Beverage,Dining out
11/04/2024,Osko Withdrawal               11Apr21:32 Magda,500,,479110.11,Withdrawals & Transfers,Withdrawal
11/04/2024,Internet Withdrawal           11Apr06:03 To 1160084689040,802.35,,479610.11,Withdrawals & Transfers,Funds transfer
11/04/2024,Osko Withdrawal               11Apr01:27 N  Ahmed,150,,480412.46,Withdrawals & Transfers,Withdrawal
10/04/2024,Osko Withdrawal               10Apr18:22 Ada,2000,,480562.46,Withdrawals & Transfers,Withdrawal
9/04/2024,Internet Withdrawal           09Apr16:44 To 1160084689040,900,,482562.46,Withdrawals & Transfers,Funds transfer
9/04/2024,Osko Withdrawal               09Apr16:43 N  Ahmed,50,,483462.46,Withdrawals & Transfers,Withdrawal
9/04/2024,Atm Withdrawal                09Apr15:59 Atmx 139 Oconnell St   North Adelaid08Au,500,,483512.46,Withdrawals & Transfers,ATM & EFTPOS
9/04/2024,Atm Withdrawal                09Apr12:54 Rundle Place Os          Adelaide     Au,1300,,484012.46,Withdrawals & Transfers,ATM & EFTPOS
8/04/2024,Raa 35036678_10_1,20.08,,485312.46,Transport & Travel,Vehicle Expenses
6/04/2024,Visa Purchase                 03Apr Coinjar              Internet,2500,,485332.54,Withdrawals & Transfers,Funds transfer
6/04/2024,Foreign Currency Conversn Fee,23.67,,487832.54,Fees & Charges,Fees & Charges
6/04/2024,Visa Cash Advance             04Apr Hkd4015.00 Airport Atm,789.14,,487856.21,Withdrawals & Transfers,ATM & EFTPOS
6/04/2024,Osko Withdrawal               05Apr22:24 Magda,300,,488645.35,Withdrawals & Transfers,Withdrawal
5/04/2024,Visa Purchase                 02Apr Coinbase Australia   Www.Coinb,500,,488945.35,Withdrawals & Transfers,Funds transfer
5/04/2024,Visa Purchase                 02Apr City Bbq & Yum Cha P Rundle Ma,19.6,,489445.35,Food & Beverage,Dining out
5/04/2024,Internet Withdrawal           05Apr06:03 To 0280074830940,802.35,,489464.95,Withdrawals & Transfers,Funds transfer
5/04/2024,Internet Withdrawal           05Apr06:03 To 802-919 001908567,1000,,490267.3,Withdrawals & Transfers,Funds transfer
4/04/2024,Visa Purchase                 02Apr Www.Banxa.Com        Cremorne,500,,491267.3,Withdrawals & Transfers,Funds transfer
4/04/2024,Osko Withdrawal               04Apr13:57 Superhero,2000,,491767.3,Withdrawals & Transfers,Withdrawal
4/04/2024,Internet Withdrawal           04Apr06:01 To 1160084689040,802.35,,493767.3,Withdrawals & Transfers,Funds transfer
3/04/2024,Osko Withdrawal               03Apr10:36 141167387 Ozforexptyltd,20000,,494569.65,Withdrawals & Transfers,Withdrawal
3/04/2024,Osko Withdrawal               03Apr09:06 Ada,1000,,514569.65,Withdrawals & Transfers,Withdrawal
2/04/2024,Raa 35878759_5_1,31.5,,515569.65,Transport & Travel,Vehicle Expenses
2/04/2024,Visa Purchase                 28Mar 2Co.Com*Revouninstal Amsterdam,19.16,,515601.15,Home & Property,Technology & Appliances
2/04/2024,Raa 35676928_6_1,18.25,,515620.31,Transport & Travel,Vehicle Expenses
2/04/2024,Osko Withdrawal               02Apr21:04 Andrew Maul,500,,515638.56,Withdrawals & Transfers,Withdrawal
2/04/2024,Osko Withdrawal               31Mar18:52 Magda,250,,516138.56,Withdrawals & Transfers,Withdrawal
30/03/2024,Eftpos Debit                  30Mar12:33 Beem\\C627Ee1A674F4Db5Acf10Eaa6D1E059D,26,,516388.56,Withdrawals & Transfers,Funds transfer
30/03/2024,Internet Withdrawal           29Mar06:04 To 0280074830940,802.35,,516414.56,Withdrawals & Transfers,Funds transfer
30/03/2024,Internet Withdrawal           29Mar06:04 To 802-919 001908567,1000,,517216.91,Withdrawals & Transfers,Funds transfer
28/03/2024,Property Managme Rent,,1199.9,518216.91,Deposits,Deposit
28/03/2024,Osko Withdrawal               28Mar16:38 Ada,1000,,517017.01,Withdrawals & Transfers,Withdrawal
28/03/2024,Osko Withdrawal               28Mar11:36 Kelly Deen,1200,,518017.01,Withdrawals & Transfers,Withdrawal
28/03/2024,Internet Withdrawal           28Mar06:07 To 802-919 001908567,1000,,519217.01,Withdrawals & Transfers,Funds transfer
28/03/2024,Internet Withdrawal           28Mar06:07 To 1160084689040,802.35,,520217.01,Withdrawals & Transfers,Funds transfer
28/03/2024,Osko Withdrawal               28Mar00:39 Magda,1000,,521019.36,Withdrawals & Transfers,Withdrawal
27/03/2024,Visa Purchase                 24Mar Bakery On O'Connell  North Ade,24.44,,522019.36,Food & Beverage,Food & Groceries
27/03/2024,Visa Purchase                 25Mar Sq *Mk2 Vietnamese   Adelaide,10.5,,522043.8,Food & Beverage,Dining out
27/03/2024,Osko Withdrawal               27Mar12:39 Michelle,200,,522054.3,Withdrawals & Transfers,Withdrawal
27/03/2024,Osko Withdrawal               27Mar05:39 Ada,1000,,522254.3,Withdrawals & Transfers,Withdrawal
26/03/2024,Visa Purchase                 23Mar Bakery On O'Connell  North Ade,12.63,,523254.3,Food & Beverage,Food & Groceries
26/03/2024,Visa Purchase                 24Mar Bakers Delight       North Ade,3.5,,523266.93,Food & Beverage,Food & Groceries
25/03/2024,Visa Purchase                 22Mar Just Guys Sa Pty Ltd Adelaide,40,,523270.43,Retail & Personal,Retail (shopping)
25/03/2024,Visa Purchase                 21Mar Bakery On O'Connell  North Ade,18.79,,523310.43,Food & Beverage,Food & Groceries
25/03/2024,Visa Purchase                 22Mar Tea Tree Infinity Pt Adelaide,15.53,,523329.22,Food & Beverage,Dining out
25/03/2024,Internet Withdrawal           24Mar09:46 To 1160084689040,802.35,,523344.75,Withdrawals & Transfers,Funds transfer
22/03/2024,Visa Purchase                 19Mar Bakery On O'Connell  North Ade,21.52,,524147.1,Food & Beverage,Food & Groceries
22/03/2024,Osko Withdrawal               22Mar12:41 Michelle,100,,524168.62,Withdrawals & Transfers,Withdrawal
22/03/2024,Cardless Atm Withdrawal       22Mar11:23 Rundle Place Os          Adelaide     Au,500,,524268.62,Withdrawals & Transfers,ATM & EFTPOS
22/03/2024,Osko Withdrawal               22Mar10:08 Superhero,1000,,524768.62,Withdrawals & Transfers,Withdrawal
21/03/2024,Allianz Aust 1Rd221368018824081,147.55,,525768.62,Bills & Payments,Insurance
21/03/2024,Allianz Aust 1Rd220985018824081,23.13,,525916.17,Bills & Payments,Insurance
21/03/2024,Visa Purchase                 19Mar City Bbq & Yum Cha P Rundle Ma,19.6,,525939.3,Food & Beverage,Dining out
21/03/2024,Visa Purchase                 19Mar Shijia Service Pty L Adelaide,12.07,,525958.9,Food & Beverage,Food & Groceries
21/03/2024,Osko Withdrawal               21Mar15:48 Superhero,1000,,525970.97,Withdrawals & Transfers,Withdrawal
21/03/2024,Osko Withdrawal               21Mar15:46 Magda,500,,526970.97,Withdrawals & Transfers,Withdrawal
21/03/2024,Atm Withdrawal                21Mar11:39 Atmx 139 Oconnell St   North Adelaid08Au,1000,,527470.97,Withdrawals & Transfers,ATM & EFTPOS
20/03/2024,Visa Purchase                 18Mar City Bbq & Yum Cha P Rundle Ma,19.6,,528470.97,Food & Beverage,Dining out
19/03/2024,Visa Purchase                 16Mar Smp*The Flying Fig   North Ade,6.8,,528490.57,Food & Beverage,Food & Groceries
19/03/2024,Osko Withdrawal               19Mar21:11 Kelly Deen,1200,,528497.37,Withdrawals & Transfers,Withdrawal
19/03/2024,Osko Deposit                  19Mar07:35 Mrs Michelle Ann Russell,,150,529697.37,Deposits,Deposit
18/03/2024,Visa Purchase                 14Mar Bakery On O'Connell  North Ade,25.05,,529547.37,Food & Beverage,Food & Groceries
18/03/2024,Visa Purchase                 15Mar Qkitchenvietnamese   Adelaide,16,,529572.42,Food & Beverage,Dining out
18/03/2024,Osko Deposit                  18Mar17:43 Courtney Anne Girdler Sweet Image Hire,,500,529588.42,Deposits,Deposit
18/03/2024,Cardless Atm Withdrawal       18Mar13:02 Rundle Place Os          Adelaide     Au,500,,529088.42,Withdrawals & Transfers,ATM & EFTPOS
18/03/2024,Internet Withdrawal           17Mar15:24 To 1160084689040,5412.47,,529588.42,Withdrawals & Transfers,Funds transfer
16/03/2024,Visa Purchase                 14Mar Qkitchenvietnamese   Adelaide,10,,535000.89,Food & Beverage,Dining out
16/03/2024,Loan Repayment S.514.2655406.00,4924,,535010.89,Home & Property,Mortgage & Rent
15/03/2024,Visa Purchase                 13Mar Tea Tree Infinity Pt Adelaide,20.4,,539934.89,Food & Beverage,Dining out
15/03/2024,Property Managme Rent,,1199.9,539955.29,Deposits,Deposit
15/03/2024,Osko Withdrawal               15Mar21:40 Magda,750,,538755.39,Withdrawals & Transfers,Withdrawal
15/03/2024,Osko Withdrawal               15Mar08:47 Superhero,1000,,539505.39,Withdrawals & Transfers,Withdrawal
14/03/2024,Raa 35616154_6_1,78.58,,540505.39,Transport & Travel,Vehicle Expenses
14/03/2024,Visa Purchase                 12Mar Gt & Hg Pty Ltd      North Ade,11.48,,540583.97,Food & Beverage,Food & Groceries
14/03/2024,Visa Purchase                 12Mar Bakers Delight       North Ade,6.9,,540595.45,Food & Beverage,Food & Groceries
13/03/2024,Osko Deposit                  13Mar11:08 Mrs Michelle Ann Russell,,300,540602.35,Deposits,Deposit
13/03/2024,Osko Deposit                  13Mar09:02 Courtney Anne Girdler Sweet Image Hire,,5000,540302.35,Deposits,Deposit
12/03/2024,American Express 376012649071009,12991.49,,535302.35,Bills & Payments,Expenses & Payments
12/03/2024,Visa Purchase                 11Mar Medibank Phi Debit   Melbourne,560.69,,548293.84,Bills & Payments,Insurance
12/03/2024,Osko Deposit                  12Mar18:32 Courtney Anne Girdler Sweet Image Hire,,5000,548854.53,Deposits,Deposit
12/03/2024,Osko Withdrawal               12Mar16:16 Ada,3000,,543854.53,Withdrawals & Transfers,Withdrawal
11/03/2024,Atm Withdrawal                10Mar17:38 Atmx 139 Oconnell St   North Adelaid08Au,500,,546854.53,Withdrawals & Transfers,ATM & EFTPOS
11/03/2024,Atm Withdrawal                10Mar16:52 Atmx 139 Oconnell St   North Adelaid08Au,1000,,547354.53,Withdrawals & Transfers,ATM & EFTPOS
11/03/2024,Eftpos Debit                  10Mar11:04 Beem\\Afe7B4C8393E43C3B63Ddd15C1D3678F,10,,548354.53,Withdrawals & Transfers,Funds transfer
11/03/2024,Osko Withdrawal               10Mar00:12 Ada,5000,,548364.53,Withdrawals & Transfers,Withdrawal
9/03/2024,Osko Withdrawal               09Mar13:33 Michelle,100,,553364.53,Withdrawals & Transfers,Withdrawal
9/03/2024,Osko Withdrawal               09Mar11:00 Kelly Deen,2000,,553464.53,Withdrawals & Transfers,Withdrawal
8/03/2024,Visa Purchase                 05Mar Bakery On O'Connell  North Ade,20.81,,555464.53,Food & Beverage,Food & Groceries
8/03/2024,Tfr Wdl BPAY Internet         08Mar14:23 140415178312        Legal Service Pay Rp,956.2,,555485.34,Bills & Payments,Professional & Govt services
8/03/2024,Internet Withdrawal           08Mar14:11 To 9000204517840,2000,,556441.54,Withdrawals & Transfers,Funds transfer
8/03/2024,Atm Withdrawal                08Mar12:23 Banksa                Adelaide     5  Au,2000,,558441.54,Withdrawals & Transfers,ATM & EFTPOS
8/03/2024,Osko Withdrawal               08Mar09:09 Superhero,1000,,560441.54,Withdrawals & Transfers,Withdrawal
7/03/2024,Atm Withdrawal                07Mar19:25 Atmx 139 Oconnell St   North Adelaid08Au,2000,,561441.54,Withdrawals & Transfers,ATM & EFTPOS
7/03/2024,Osko Deposit                  07Mar10:24 Lucas Chapman,,175,563441.54,Deposits,Deposit
6/03/2024,Raa 35036678_9_1,20.08,,563266.54,Transport & Travel,Vehicle Expenses
6/03/2024,Eftpos Debit                  05Mar23:06 Beem\\D558B42A22644591Ba76B29108Adfbb2,50,,563286.62,Withdrawals & Transfers,Funds transfer
6/03/2024,Osko Withdrawal               06Mar00:00 Michelle,250,,563336.62,Withdrawals & Transfers,Withdrawal
5/03/2024,Visa Purchase                 02Mar Tiantian Asiangrocer Glenunga,50.2,,563586.62,Food & Beverage,Food & Groceries
4/03/2024,Rtgs Inward Payment Sgb2403040303205St James Place Intl,,200000,563636.82,Deposits,Deposit
2/03/2024,Visa Purchase                 28Feb Bakery On O'Connell  North Ade,11.11,,363636.82,Food & Beverage,Food & Groceries
2/03/2024,Eftpos Debit                  02Mar00:04 Uber Eats* Eats\,41.62,,363647.93,Food & Beverage,Dining out
1/03/2024,Osko Withdrawal               01Mar17:46 Superhero,1000,,363689.55,Withdrawals & Transfers,Withdrawal
29/02/2024,Raa 35878759_4_1,31.5,,364689.55,Transport & Travel,Vehicle Expenses
29/02/2024,Raa 35676928_5_1,18.25,,364721.05,Transport & Travel,Vehicle Expenses
29/02/2024,Property Managme Rent,,1199.9,364739.3,Deposits,Deposit
29/02/2024,Atm Withdrawal                28Feb21:44 Atmx 139 Oconnell St   North Adelaid08Au,1500,,363539.4,Withdrawals & Transfers,ATM & EFTPOS
28/02/2024,Osko Withdrawal               28Feb15:21 K Bond,5000,,365039.4,Withdrawals & Transfers,Withdrawal
27/02/2024,Visa Purchase                 24Feb The Woody Hotel Pty  Woodside,23,,370039.4,Food & Beverage,Beverages
27/02/2024,Osko Withdrawal               27Feb19:08 Kelly Deen,2000,,370062.4,Withdrawals & Transfers,Withdrawal
26/02/2024,Eftpos Debit                  25Feb11:16 Ozt*The Beasts Of Bour\,134.45,,372062.4,Entertainment & Recreation,Sports & Leisure
24/02/2024,Visa Purchase                 20Feb Foodworks North Adel North Ade,44.51,,372196.85,Food & Beverage,Food & Groceries
24/02/2024,Visa Purchase                 21Feb Bakery On O'Connell  North Ade,11.11,,372241.36,Food & Beverage,Food & Groceries
24/02/2024,Osko Withdrawal               24Feb13:16 Hayley,350,,372252.47,Withdrawals & Transfers,Withdrawal
23/02/2024,Visa Purchase                 20Feb Snowtown Roadhouse   Snowtown,30.01,,372602.47,Transport & Travel,Petrol
23/02/2024,Visa Purchase                 21Feb Sq *Ricky's Chicken  North Ade,20.23,,372632.48,Food & Beverage,Dining out
22/02/2024,Visa Purchase                 19Feb Hotel Augusta        Port Augu,294.2,,372652.71,Food & Beverage,Dining out
22/02/2024,Visa Purchase                 20Feb Pasta Go Go North Ad North Ade,14.4,,372946.91,Food & Beverage,Dining out
22/02/2024,Visa Purchase                 19Feb Hotel Augusta        Port Augu,9.2,,372961.31,Food & Beverage,Dining out
21/02/2024,Allianz Aust 1Rd221368015624052,147.55,,372970.51,Bills & Payments,Insurance
21/02/2024,Visa Purchase                 18Feb L.H. Perry & Sons Pt Snowtown,40.04,,373118.06,Transport & Travel,Petrol
21/02/2024,Allianz Aust 1Rd220985015624052,23.13,,373158.1,Bills & Payments,Insurance
21/02/2024,Atm Withdrawal                21Feb20:27 Atmx 139 Oconnell St   North Adelaid08Au,2000,,373181.23,Withdrawals & Transfers,ATM & EFTPOS
20/02/2024,Visa Purchase                 18Feb Sq *Grange Slsc      Grange,5.5,,375181.23,Bills & Payments,Memberships
20/02/2024,Osko Withdrawal               20Feb18:08 Superhero,2000,,375186.73,Withdrawals & Transfers,Withdrawal
19/02/2024,Osko Withdrawal               19Feb20:20 Liz,4686.14,,377186.73,Withdrawals & Transfers,Withdrawal
19/02/2024,Osko Withdrawal               19Feb16:04 Liz,2000,,381872.87,Withdrawals & Transfers,Withdrawal
19/02/2024,Cardless Atm Withdrawal       17Feb23:11 Westpac               Narellan     2  Au,500,,383872.87,Withdrawals & Transfers,ATM & EFTPOS
16/02/2024,Visa Purchase                 14Feb City Bbq & Yum Cha P Rundle Ma,19.6,,384372.87,Food & Beverage,Dining out
16/02/2024,Loan Repayment S.514.2655406.00,4924,,384392.47,Home & Property,Mortgage & Rent
16/02/2024,Atm Withdrawal                16Feb13:58 Atmx 139 Oconnell St   North Adelaid08Au,2000,,389316.47,Withdrawals & Transfers,ATM & EFTPOS
15/02/2024,American Express 376012649071009,2865.59,,391316.47,Bills & Payments,Expenses & Payments
15/02/2024,Visa Purchase                 13Feb Tea Tree Infinity Pt Adelaide,16.54,,394182.06,Food & Beverage,Dining out
15/02/2024,Property Managme Rent,,1199.9,394198.6,Deposits,Deposit
15/02/2024,Osko Withdrawal               15Feb12:53 Kelly Deen,2000,,392998.7,Withdrawals & Transfers,Withdrawal
14/02/2024,Raa 35616154_5_1,78.58,,394998.7,Transport & Travel,Vehicle Expenses
14/02/2024,Internet Withdrawal           14Feb11:39 To 037-080 000070293,18701.27,,395077.28,Withdrawals & Transfers,Funds transfer
14/02/2024,Telegraphic Tfr (Rtgs) Fee,35,,413778.55,Fees & Charges,Fees & Charges
14/02/2024,Telegraphic Tfr (Rtgs),181657.36,,413813.55,Withdrawals & Transfers,Funds transfer
14/02/2024,Internet Deposit              14Feb10:57 From 0280074830940,,5000,595470.91,Deposits,Deposit
13/02/2024,Visa Purchase                 12Feb Medibank Phi Debit   Melbourne,560.69,,590470.91,Bills & Payments,Insurance
13/02/2024,Visa Purchase                 11Feb Bakery On O'Connell  North Ade,27.07,,591031.6,Food & Beverage,Food & Groceries
12/02/2024,Visa Purchase                 09Feb Tea Tree Infinity Pt Adelaide,15.53,,591058.67,Food & Beverage,Dining out
12/02/2024,Atm Withdrawal                11Feb12:08 Atmx 139 Oconnell St   North Adelaid08Au,2000,,591074.2,Withdrawals & Transfers,ATM & EFTPOS
10/02/2024,Atm Withdrawal                10Feb13:52 Atmx 139 Oconnell St   North Adelaid08Au,2000,,593074.2,Withdrawals & Transfers,ATM & EFTPOS
10/02/2024,Osko Withdrawal               10Feb14:11 Kelly Deen,100,,595074.2,Withdrawals & Transfers,Withdrawal
10/02/2024,Osko Withdrawal               10Feb14:10 Kelly Deen,1200,,595174.2,Withdrawals & Transfers,Withdrawal
9/02/2024,Atm Withdrawal                09Feb18:43 Atmx 139 Oconnell St   North Adelaid08Au,2000,,596374.2,Withdrawals & Transfers,ATM & EFTPOS
8/02/2024,Internet Withdrawal           08Feb12:58 To 9000204517840,3000,,598374.2,Withdrawals & Transfers,Funds transfer
8/02/2024,Osko Withdrawal               08Feb09:02 Superhero,1000,,601374.2,Withdrawals & Transfers,Withdrawal
7/02/2024,Visa Purchase                 03Feb Krung Thep           North Ade,85.5,,602374.2,Food & Beverage,Dining out
6/02/2024,Raa 35036678_8_1,20.08,,602459.7,Transport & Travel,Vehicle Expenses
5/02/2024,Osko Withdrawal               05Feb17:45 Hayley,300,,602479.78,Withdrawals & Transfers,Withdrawal
3/02/2024,Osko Withdrawal               03Feb00:29 K Bond,500,,602779.78,Withdrawals & Transfers,Withdrawal
1/02/2024,Osko Withdrawal               01Feb21:21 For Uber Tomorrow K Bond,100,,603279.78,Withdrawals & Transfers,Withdrawal
31/01/2024,Visa Purchase                 28Jan A Cuppa Coffee House Perth,12.95,,603379.78,Food & Beverage,Beverages
31/01/2024,Property Managme Rent,,1199.9,603392.73,Deposits,Deposit
31/01/2024,Osko Withdrawal               31Jan19:26 Superhero,1000,,602192.83,Withdrawals & Transfers,Withdrawal
31/01/2024,Rtgs Inward Payment Sgb2401310110148Andrew Ian Maul,,12058.94,603192.83,Deposits,Deposit
30/01/2024,Raa 35878759_3_1,31.5,,591133.89,Transport & Travel,Vehicle Expenses
30/01/2024,Raa 35676928_4_1,18.25,,591165.39,Transport & Travel,Vehicle Expenses
30/01/2024,Osko Withdrawal               30Jan17:09 Gardening Ada,300,,591183.64,Withdrawals & Transfers,Withdrawal
30/01/2024,Osko Withdrawal               30Jan15:48 Kelly Deen,2000,,591483.64,Withdrawals & Transfers,Withdrawal
29/01/2024,Visa Purchase                 24Jan Singh Thai Restauran Adelaide,23.5,,593483.64,Food & Beverage,Dining out
29/01/2024,Eftpos Credit                 29Jan09:55 Beem It\,,300,593507.14,Deposits,Deposit
29/01/2024,Eftpos Debit                  29Jan09:54 Beem It\,450,,593207.14,Withdrawals & Transfers,Funds transfer
27/01/2024,Eftpos Debit                  27Jan14:08 Apex*Pandemonium - Mel\,750,,593657.14,Entertainment & Recreation,Sports & Leisure
27/01/2024,Eftpos Debit                  27Jan00:09 Beem It\,100,,594407.14,Withdrawals & Transfers,Funds transfer
27/01/2024,Tfr Wdl BPAY Internet         27Jan00:56 141167387           Ozforex Pty Ltd,10000,,594507.14,Withdrawals & Transfers,Withdrawal
27/01/2024,Internet Withdrawal           26Jan06:01 To 105-900 146868640,250,,604507.14,Withdrawals & Transfers,Funds transfer
25/01/2024,Visa Purchase                 23Jan Adelaide Health Care Adelaide,40.65,,604757.14,Retail & Personal,Medical & Personal care
25/01/2024,Rtgs Inward Payment Sgb2401250108292Andrew Ian Maul,,150145.08,604797.79,Deposits,Deposit
24/01/2024,Eftpos Debit                  24Jan09:48 Beem It\,50,,454652.71,Withdrawals & Transfers,Funds transfer
24/01/2024,Atm Withdrawal                24Jan11:14 Banksa                Adelaide Sa  5  Au,1500,,454702.71,Withdrawals & Transfers,ATM & EFTPOS
23/01/2024,Mcare Benefits 740168971 Gywq,,18.95,456202.71,Government payments,Centrelink payments
23/01/2024,Tfr Wdl BPAY Internet         23Jan13:58 141167387           Ozforex Pty Ltd,10000,,456183.76,Withdrawals & Transfers,Withdrawal
23/01/2024,Osko Withdrawal               23Jan11:24 Superhero,2000,,466183.76,Withdrawals & Transfers,Withdrawal
22/01/2024,Allianz Aust 1Rd221368012424022,147.55,,468183.76,Bills & Payments,Insurance
22/01/2024,Allianz Aust 1Rd220985012424022,23.13,,468331.31,Bills & Payments,Insurance
22/01/2024,Eftpos Debit                  21Jan08:35 Beem It\,50,,468354.44,Withdrawals & Transfers,Funds transfer
20/01/2024,Visa Purchase                 17Jan Bakery On O'Connell  North Ade,22.73,,468404.44,Food & Beverage,Food & Groceries
20/01/2024,Eftpos Debit                  20Jan07:05 Beem It\,50,,468427.17,Withdrawals & Transfers,Funds transfer
20/01/2024,Osko Deposit                  20Jan15:54 Mr Ian John Hill,,150,468477.17,Deposits,Deposit
19/01/2024,American Express 376012649071009,24034.87,,468327.17,Bills & Payments,Expenses & Payments
19/01/2024,Visa Purchase                 16Jan Bakery On O'Connell  North Ade,13.03,,492362.04,Food & Beverage,Food & Groceries
19/01/2024,Internet Withdrawal           19Jan06:02 To 105-900 146868640,250,,492375.07,Withdrawals & Transfers,Funds transfer
18/01/2024,Visa Purchase                 16Jan City Of Adelaide     Adelaide,1373.15,,492625.07,Bills & Payments,Tax payments
17/01/2024,Visa Purchase                 15Jan Kate Le Cong         Adelaide,171.35,,493998.22,Retail & Personal,Medical & Personal care
17/01/2024,Visa Purchase                 15Jan Saffron Restaurant   Adelaide,6.09,,494169.57,Food & Beverage,Dining out
17/01/2024,Atm Withdrawal                17Jan20:03 Atmx 139 Oconnell St   North Adelaid08Au,500,,494175.66,Withdrawals & Transfers,ATM & EFTPOS
16/01/2024,Eftpos Debit                  16Jan09:38 Beem It\,50,,494675.66,Withdrawals & Transfers,Funds transfer
16/01/2024,Loan Repayment S.514.2655406.00,4839,,494725.66,Home & Property,Mortgage & Rent
16/01/2024,Eftpos Credit                 16Jan06:06 Beem It\,,250,499564.66,Deposits,Deposit
16/01/2024,Eftpos Debit                  16Jan05:07 Beem It\,250,,499314.66,Withdrawals & Transfers,Funds transfer
16/01/2024,Eftpos Debit                  15Jan11:53 Beem It\,100,,499564.66,Withdrawals & Transfers,Funds transfer
15/01/2024,Raa 35616154_4_1,78.58,,499664.66,Transport & Travel,Vehicle Expenses
15/01/2024,Visa Purchase                 11Jan Smp*Cafe Fellini     North Ade,37.41,,499743.24,Food & Beverage,Dining out
15/01/2024,Visa Purchase                 12Jan Just Guys Sa Pty Ltd Adelaide,35,,499780.65,Retail & Personal,Retail (shopping)
15/01/2024,Property Managme Rent,,1199.9,499815.65,Deposits,Deposit
15/01/2024,Mcare Benefits 734156288 Gywq,,80.1,498615.75,Government payments,Centrelink payments
15/01/2024,Osko Withdrawal               15Jan19:04 Michelle,150,,498535.65,Withdrawals & Transfers,Withdrawal
15/01/2024,Eftpos Debit                  15Jan05:56 Bakery On O'Connell   North Adelaidsa Au,17.58,,498685.65,Food & Beverage,Food & Groceries
12/01/2024,Visa Purchase                 09Jan Epoch  *Tecomltd     Limassol,85.97,,498703.23,Retail & Personal,Retail (shopping)
12/01/2024,Atm Withdrawal                12Jan20:34 Atmx 139 Oconnell St   North Adelaid08Au,2000,,498789.2,Withdrawals & Transfers,ATM & EFTPOS
12/01/2024,Internet Withdrawal           12Jan06:00 To 105-900 146868640,250,,500789.2,Withdrawals & Transfers,Funds transfer
11/01/2024,Visa Purchase                 08Jan Australian Vaporizer Newmarket,847.9,,501039.2,Retail & Personal,Medical & Personal care
11/01/2024,Visa Purchase                 10Jan Medibank Phi Debit   Melbourne,560.69,,501887.1,Bills & Payments,Insurance
11/01/2024,Osko Withdrawal               11Jan21:58 Superhero,1000,,502447.79,Withdrawals & Transfers,Withdrawal
10/01/2024,Visa Purchase                 06Jan Zambrero Nth Adl     North Ade,51.2,,503447.79,Food & Beverage,Dining out
10/01/2024,Atm Withdrawal                10Jan17:00 Atmx 139 Oconnell St   North Adelaid08Au,2000,,503498.99,Withdrawals & Transfers,ATM & EFTPOS
10/01/2024,Osko Withdrawal               10Jan17:16 Kelly Deen,1050,,505498.99,Withdrawals & Transfers,Withdrawal
9/01/2024,Visa Purchase                 06Jan Bakery On O'Connell  North Ade,23.13,,506548.99,Food & Beverage,Food & Groceries
9/01/2024,Visa Purchase                 07Jan Pasta Go Go North Ad North Ade,14.4,,506572.12,Food & Beverage,Dining out
8/01/2024,Raa 35036678_7_1,20.08,,506586.52,Transport & Travel,Vehicle Expenses
8/01/2024,Tfr Wdl BPAY Internet         08Jan16:13 0220891204          Sa Water,339.66,,506606.6,Bills & Payments,Utilities & Rates
8/01/2024,Internet Withdrawal           07Jan10:45 To 9000204517840,1000,,506946.26,Withdrawals & Transfers,Funds transfer
8/01/2024,Eftpos Debit                  06Jan22:40 Beem It\,100,,507946.26,Withdrawals & Transfers,Funds transfer
6/01/2024,Visa Purchase                 04Jan Star Chemist Prospec Prospect,63.96,,508046.26,Retail & Personal,Medical & Personal care
5/01/2024,Osko Withdrawal               05Jan12:21 Superhero,1000,,508110.22,Withdrawals & Transfers,Withdrawal
5/01/2024,Osko Withdrawal               05Jan12:20 Michelle,150,,509110.22,Withdrawals & Transfers,Withdrawal
5/01/2024,Internet Withdrawal           05Jan06:02 To 105-900 146868640,250,,509260.22,Withdrawals & Transfers,Funds transfer
4/01/2024,Atm Withdrawal                04Jan13:12 Atmx 139 Oconnell St   North Adelaid08Au,2000,,509510.22,Withdrawals & Transfers,ATM & EFTPOS
4/01/2024,Eftpos Debit                  03Jan14:45 Beem It\,450,,511510.22,Withdrawals & Transfers,Funds transfer
3/01/2024,Osko Deposit                  03Jan14:42 Mrs Michelle Ann Russell,,450,511960.22,Deposits,Deposit
2/01/2024,Visa Purchase                 29Dec City Bbq & Yum Cha P Rundle Ma,11.8,,511510.22,Food & Beverage,Dining out
2/01/2024,Visa Purchase                 29Dec Bread Temptation     Adelaide,4.7,,511522.02,Food & Beverage,Food & Groceries
2/01/2024,Property Managme Rent,,1199.9,511526.72,Deposits,Deposit
2/01/2024,Eftpos Debit                  01Jan11:38 Beem It\,100,,510326.82,Withdrawals & Transfers,Funds transfer
2/01/2024,Eftpos Debit                  01Jan09:30 Beem It\,100,,510426.82,Withdrawals & Transfers,Funds transfer
2/01/2024,Eftpos Debit                  01Jan03:59 Beem It\,70,,510526.82,Withdrawals & Transfers,Funds transfer
2/01/2024,Internet Withdrawal           31Dec16:57 To 9000204517840,1000,,510596.82,Withdrawals & Transfers,Funds transfer
30/12/2023,Osko Withdrawal               30Dec20:09 Penny,500,,511596.82,Withdrawals & Transfers,Withdrawal
30/12/2023,Eftpos Debit                  29Dec22:25 Beem It\,150,,512096.82,Withdrawals & Transfers,Funds transfer
29/12/2023,Raa 35878759_2_1,31.5,,512246.82,Transport & Travel,Vehicle Expenses
29/12/2023,Raa 35676928_3_1,18.25,,512278.32,Transport & Travel,Vehicle Expenses
29/12/2023,Cardless Atm Withdrawal       29Dec15:48 Banksa                Adelaide Sa  5  Au,500,,512296.57,Withdrawals & Transfers,ATM & EFTPOS
29/12/2023,Internet Withdrawal           29Dec06:00 To 105-900 146868640,250,,512796.57,Withdrawals & Transfers,Funds transfer
29/12/2023,Eftpos Debit                  28Dec16:32 Beem It\,250,,513046.57,Withdrawals & Transfers,Funds transfer
28/12/2023,Osko Withdrawal               28Dec19:09 K Bond,150,,513296.57,Withdrawals & Transfers,Withdrawal
28/12/2023,Osko Withdrawal               28Dec17:24 Superhero,1000,,513446.57,Withdrawals & Transfers,Withdrawal
28/12/2023,Osko Withdrawal               28Dec17:23 K Bond,450,,514446.57,Withdrawals & Transfers,Withdrawal
27/12/2023,Eftpos Debit                  27Dec03:29 Beem It\,100,,514896.57,Withdrawals & Transfers,Funds transfer
27/12/2023,Atm Withdrawal                26Dec12:29 Atmx 139 Oconnell St   North Adelaid08Au,2000,,514996.57,Withdrawals & Transfers,ATM & EFTPOS
27/12/2023,Eftpos Credit                 23Dec14:40 Beem It\,,70,516996.57,Deposits,Deposit
23/12/2023,Visa Purchase                 20Dec Bakery On O'Connell  North Ade,24.65,,516926.57,Food & Beverage,Food & Groceries
23/12/2023,Osko Withdrawal               23Dec12:06 Kelly Deen,2100,,516951.22,Withdrawals & Transfers,Withdrawal
23/12/2023,Osko Withdrawal               23Dec11:37 Hayley,250,,519051.22,Withdrawals & Transfers,Withdrawal
23/12/2023,Eftpos Credit                 22Dec19:03 Beem It\,,250,519301.22,Deposits,Deposit
23/12/2023,Internet Withdrawal           23Dec05:37 To 105-900 146868640,250,,519051.22,Withdrawals & Transfers,Funds transfer
22/12/2023,Visa Purchase                 20Dec Metro Convenience Pt Adelaide,62.11,,519301.22,Food & Beverage,Food & Groceries
22/12/2023,Osko Withdrawal               22Dec18:38 Michelle,400,,519363.33,Withdrawals & Transfers,Withdrawal
22/12/2023,Atm Withdrawal                22Dec13:49 Rundle Place Os          Adelaide     Au,200,,519763.33,Withdrawals & Transfers,ATM & EFTPOS
22/12/2023,Osko Withdrawal               22Dec11:02 Superhero,1000,,519963.33,Withdrawals & Transfers,Withdrawal
22/12/2023,Internet Withdrawal           22Dec06:05 To 105-900 146868640,250,,520963.33,Withdrawals & Transfers,Funds transfer
21/12/2023,Allianz Aust 1Rd221368018523355,147.55,,521213.33,Bills & Payments,Insurance
21/12/2023,Allianz Aust 1Rd220985018523355,23.13,,521360.88,Bills & Payments,Insurance
21/12/2023,Eftpos Debit                  21Dec01:16 Beem It\,200,,521384.01,Withdrawals & Transfers,Funds transfer
20/12/2023,Visa Purchase                 18Dec K M Mansfield        North Ade,250,,521584.01,Retail & Personal,Medical & Personal care
20/12/2023,Visa Purchase                 17Dec Wink Wealth Pty L Td Frenchs F,53.73,,521834.01,Entertainment & Recreation,TV
19/12/2023,American Express 376012649071009,597.26,,521887.74,Bills & Payments,Expenses & Payments
19/12/2023,Eftpos Credit                 18Dec14:40 Beem It\,,190,522485,Deposits,Deposit
18/12/2023,Eftpos Credit                 18Dec16:11 Medicare Benefit Sn\                  Au,,137.05,522295,Deposits,Deposit
18/12/2023,Atm Withdrawal                17Dec16:39 Atmx 139 Oconnell St   North Adelaid08Au,1800,,522157.95,Withdrawals & Transfers,ATM & EFTPOS
18/12/2023,Atm Withdrawal                17Dec16:39 Atmx 139 Oconnell St   North Adelaid08Au,200,,523957.95,Withdrawals & Transfers,ATM & EFTPOS
16/12/2023,Visa Purchase                 12Dec Foodworks North Adel North Ade,33.56,,524157.95,Food & Beverage,Food & Groceries
16/12/2023,Loan Repayment S.514.2655406.00,4839,,524191.51,Home & Property,Mortgage & Rent
16/12/2023,Internet Withdrawal           16Dec05:39 To 105-900 146868640,250,,529030.51,Withdrawals & Transfers,Funds transfer
15/12/2023,Property Managme Rent,,1199.9,529280.51,Deposits,Deposit
15/12/2023,Osko Withdrawal               15Dec21:16 Ada,250,,528080.61,Withdrawals & Transfers,Withdrawal
14/12/2023,Raa 35616154_3_1,78.58,,528330.61,Transport & Travel,Vehicle Expenses
14/12/2023,Atm Withdrawal                14Dec17:02 Atmx 139 Oconnell St   North Adelaid08Au,1500,,528409.19,Withdrawals & Transfers,ATM & EFTPOS
14/12/2023,Osko Withdrawal               14Dec13:46 Superhero,1000,,529909.19,Withdrawals & Transfers,Withdrawal
13/12/2023,Visa Purchase                 11Dec Krung Thep           North Ade,51.5,,530909.19,Food & Beverage,Dining out
12/12/2023,Visa Purchase                 11Dec Medibank Phi Debit   Melbourne,560.69,,530960.69,Bills & Payments,Insurance
12/12/2023,Visa Purchase                 08Dec Smp*Cafe Fellini     North Ade,34.26,,531521.38,Food & Beverage,Dining out
12/12/2023,Eftpos Debit                  12Dec09:30 Bakery On O'Connell   North Adelaidsa Au,16.97,,531555.64,Food & Beverage,Food & Groceries
11/12/2023,Visa Purchase                 06Dec Telstra Limited      Adelaide,1199,,531572.61,Bills & Payments,Telecommunications
11/12/2023,Osko Withdrawal               11Dec16:09 Kelly Deen,2100,,532771.61,Withdrawals & Transfers,Withdrawal
11/12/2023,Osko Withdrawal               09Dec23:19 Ada,1500,,534871.61,Withdrawals & Transfers,Withdrawal
8/12/2023,Visa Purchase                 04Dec Foodworks North Adel North Ade,38.15,,536371.61,Food & Beverage,Food & Groceries
8/12/2023,Visa Purchase                 04Dec Telstra Limited      Adelaide,35,,536409.76,Bills & Payments,Telecommunications
8/12/2023,Visa Purchase                 06Dec Tea Tree Infinity Pt Adelaide,18.88,,536444.76,Food & Beverage,Dining out
8/12/2023,Visa Purchase                 06Dec Smgb Grenfell St     Adelaide,3.99,,536463.64,Bills & Payments,Gifts & Donations
7/12/2023,Visa Purchase                 03Dec Foodworks North Adel North Ade,42.12,,536467.63,Food & Beverage,Food & Groceries
7/12/2023,Tfr Wdl BPAY Internet         07Dec14:29 140359013095        Legal Service Pay Rp,3746.48,,536509.75,Bills & Payments,Professional & Govt services
7/12/2023,Eftpos Debit                  07Dec11:51 Funk Coffee And Foo\Adelaide          Au,11.5,,540256.23,Food & Beverage,Beverages
6/12/2023,Visa Purchase                 02Dec Foodworks North Adel North Ade,55.25,,540267.73,Food & Beverage,Food & Groceries
6/12/2023,Visa Purchase                 04Dec Liquorland 6078      Adelaide,34,,540322.98,Food & Beverage,Beverages
6/12/2023,Raa 35036678_6_1,20.08,,540356.98,Transport & Travel,Vehicle Expenses
6/12/2023,Visa Purchase                 04Dec Tea Tree Infinity Pt Adelaide,19.89,,540377.06,Food & Beverage,Dining out
6/12/2023,Eftpos Debit                  06Dec14:25 The Golden Wattle Hot Adelaide     Sa Au,11.07,,540396.95,Food & Beverage,Dining out
5/12/2023,Visa Purchase                 02Dec Bws/123 Oconnell Str Nrth Adel,52,,540408.02,Food & Beverage,Beverages
5/12/2023,Eftpos Debit                  05Dec08:04 Beem It\,400,,540460.02,Withdrawals & Transfers,Funds transfer
5/12/2023,Eftpos Debit                  05Dec01:22 Beem It\,100,,540860.02,Withdrawals & Transfers,Funds transfer
5/12/2023,Osko Withdrawal               05Dec04:02 Ada,500,,540960.02,Withdrawals & Transfers,Withdrawal
5/12/2023,Osko Withdrawal               04Dec22:20 Uber X 2 Ada,30,,541460.02,Withdrawals & Transfers,Withdrawal
4/12/2023,Visa Purchase                 30Nov A Cuppa Coffee House Perth,11.13,,541490.02,Food & Beverage,Beverages
4/12/2023,Osko Withdrawal               04Dec21:09 Michelle,100,,541501.15,Withdrawals & Transfers,Withdrawal
4/12/2023,Eftpos Debit                  04Dec18:47 Bakery On O'Connell   North Adelaidsa Au,12.02,,541601.15,Food & Beverage,Food & Groceries
4/12/2023,Eftpos Debit                  03Dec19:48 Bakery On O'Connell   North Adelaidsa Au,11.11,,541613.17,Food & Beverage,Food & Groceries
2/12/2023,Visa Purchase                 29Nov A Cuppa Coffee House Perth,11.13,,541624.28,Food & Beverage,Beverages
2/12/2023,Eftpos Debit                  02Dec18:50 Independent 132211    Torrensville Sa Au,14.46,,541635.41,Transport & Travel,Taxi & Rental car
2/12/2023,Atm Withdrawal                02Dec17:51 Atmx 139 Oconnell St   North Adelaid08Au,1000,,541649.87,Withdrawals & Transfers,ATM & EFTPOS
2/12/2023,Eftpos Debit                  01Dec23:32 Independent 132211    Torrensville Sa Au,37.88,,542649.87,Transport & Travel,Taxi & Rental car
1/12/2023,Osko Withdrawal               01Dec20:04 Ada,250,,542687.75,Withdrawals & Transfers,Withdrawal
1/12/2023,Osko Withdrawal               01Dec19:58 Superhero,1000,,542937.75,Withdrawals & Transfers,Withdrawal
1/12/2023,Osko Withdrawal               01Dec19:56 Hayley,2560,,543937.75,Withdrawals & Transfers,Withdrawal
1/12/2023,Internet Deposit              01Dec15:33 From 0280074830940,,4000,546497.75,Deposits,Deposit
1/12/2023,Internet Deposit              01Dec15:32 From 9000204517840,,12000,542497.75,Deposits,Deposit
1/12/2023,Osko Withdrawal               01Dec14:47 Kelly Deen,1050,,530497.75,Withdrawals & Transfers,Withdrawal
1/12/2023,Osko Withdrawal               01Dec14:46 Kelly Deen,1050,,531547.75,Withdrawals & Transfers,Withdrawal
30/11/2023,Property Managme Rent,,1199.9,532597.75,Deposits,Deposit
30/11/2023,Eftpos Debit                  30Nov11:26 Mounts Bay Liquor     Perth        Wa Au,72,,531397.85,Food & Beverage,Beverages
29/11/2023,Visa Purchase                 27Nov Officeworks 0615     Perth,130,,531469.85,Retail & Personal,Retail (shopping)
29/11/2023,Raa 35878759_1_1,31.5,,531599.85,Transport & Travel,Vehicle Expenses
29/11/2023,Visa Purchase                 25Nov Regal Theatre Fn Ltd Subiaco,20,,531631.35,Entertainment & Recreation,TV
29/11/2023,Raa 35676928_2_1,18.25,,531651.35,Transport & Travel,Vehicle Expenses
29/11/2023,Visa Purchase                 27Nov 9914_William_Streetk Hamilton,8.45,,531669.6,Food & Beverage,Dining out
29/11/2023,Eftpos Debit                  29Nov12:43 Mounts Bay Liquor     Perth        Wa Au,33,,531678.05,Food & Beverage,Beverages
29/11/2023,Osko Deposit                  29Nov12:19 Lucas Chapman,,175,531711.05,Deposits,Deposit
28/11/2023,Eftpos Debit                  28Nov08:52 Selected Enterprises  West Perth   Wa Au,32,,531536.05,Food & Beverage,Dining out
27/11/2023,American Express 376012649071009,16820.72,,531568.05,Bills & Payments,Expenses & Payments
27/11/2023,Eftpos Debit                  27Nov02:05 Beem It\,50,,548388.77,Withdrawals & Transfers,Funds transfer
25/11/2023,Visa Purchase                 22Nov Bakery On O'Connell  North Ade,24.14,,548438.77,Food & Beverage,Food & Groceries
25/11/2023,Eftpos Debit                  24Nov12:56 Beem It\,500,,548462.91,Withdrawals & Transfers,Funds transfer
24/11/2023,Osko Withdrawal               24Nov11:46 Superhero,2000,,548962.91,Withdrawals & Transfers,Withdrawal
24/11/2023,Osko Withdrawal               24Nov09:33 Stock Superhero,1000,,550962.91,Withdrawals & Transfers,Withdrawal
23/11/2023,Visa Purchase                 21Nov City Bbq & Yum Cha P Rundle Ma,19.8,,551962.91,Food & Beverage,Dining out
23/11/2023,Eftpos Debit                  23Nov08:06 Beem It\,100,,551982.71,Withdrawals & Transfers,Funds transfer
23/11/2023,Eftpos Debit                  23Nov07:42 Beem It\,25,,552082.71,Withdrawals & Transfers,Funds transfer
22/11/2023,Visa Purchase                 18Nov Foodworks North Adel North Ade,50.06,,552107.71,Food & Beverage,Food & Groceries
22/11/2023,Visa Purchase                 20Nov Krung Thep           North Ade,42,,552157.77,Food & Beverage,Dining out
22/11/2023,Atm Withdrawal                22Nov14:04 Atmx 139 Oconnell St   North Adelaid08Au,1450,,552199.77,Withdrawals & Transfers,ATM & EFTPOS
21/11/2023,Allianz Aust 1Rd221368015223325,147.55,,553649.77,Bills & Payments,Insurance
21/11/2023,Allianz Aust 1Rd220985015223325,23.13,,553797.32,Bills & Payments,Insurance
21/11/2023,Osko Withdrawal               21Nov21:40 Ada,50,,553820.45,Withdrawals & Transfers,Withdrawal
20/11/2023,Visa Purchase                 17Nov V/Cellars 3327       N Adelaid,141,,553870.45,Food & Beverage,Beverages
20/11/2023,Visa Purchase                 16Nov Bakery On O'Connell  North Ade,29.29,,554011.45,Food & Beverage,Food & Groceries
20/11/2023,Visa Purchase                 15Nov Foodworks North Adel North Ade,23.25,,554040.74,Food & Beverage,Food & Groceries
20/11/2023,Eftpos Debit                  19Nov20:23 Bakery On O'Connell   North Adelaidsa Au,17.58,,554063.99,Food & Beverage,Food & Groceries
20/11/2023,"Eftpos Debit                  19Nov20:41 Sq *North Adelaide, Bunorth Adelaidsa Au",15.5,,554081.57,Food & Beverage,Dining out
18/11/2023,Visa Purchase                 16Nov Bread Temptation     Adelaide,9.3,,554097.07,Food & Beverage,Food & Groceries
17/11/2023,Visa Purchase                 15Nov Bws/123 Oconnell Str Nrth Adel,122,,554106.37,Food & Beverage,Beverages
17/11/2023,Visa Purchase                 15Nov Nth Adel Foodland    North Ade,98.41,,554228.37,Food & Beverage,Food & Groceries
17/11/2023,Visa Purchase                 15Nov Sq *Village Asian Gr North Ade,21.6,,554326.78,Food & Beverage,Food & Groceries
17/11/2023,Visa Purchase                 14Nov Bakery On O'Connell  North Ade,11.11,,554348.38,Food & Beverage,Food & Groceries
17/11/2023,Visa Purchase                 15Nov Bakers Delight       North Ade,3.5,,554359.49,Food & Beverage,Food & Groceries
16/11/2023,Loan Repayment S.514.2655406.00,4839,,554362.99,Home & Property,Mortgage & Rent
16/11/2023,Osko Withdrawal               16Nov13:19 As Per Discussion Kelly Deen,2100,,559201.99,Withdrawals & Transfers,Withdrawal
15/11/2023,Property Managme Rent,,1199.9,561301.99,Deposits,Deposit
15/11/2023,Osko Deposit                  15Nov20:50 3 Out Of 20 Lucas Chapman,,175,560102.09,Deposits,Deposit
14/11/2023,Raa 35616154_2_1,78.58,,559927.09,Transport & Travel,Vehicle Expenses
11/11/2023,Visa Purchase                 10Nov Medibank Phi Debit   Melbourne,560.69,,560005.67,Bills & Payments,Insurance
10/11/2023,Visa Purchase                 07Nov Bakery On O'Connell  North Ade,17.58,,560566.36,Food & Beverage,Food & Groceries
9/11/2023,Visa Purchase                 06Nov Bakery On O'Connell  North Ade,18.59,,560583.94,Food & Beverage,Food & Groceries
9/11/2023,Osko Withdrawal               09Nov12:29 Liz,1000,,560602.53,Withdrawals & Transfers,Withdrawal
9/11/2023,Rtgs Inward Payment Sgb2311090103361Andrew Ian Maul,,42213.7,561602.53,Deposits,Deposit
8/11/2023,Atm Withdrawal                08Nov18:04 Atmx 139 Oconnell St   North Adelaid08Au,2000,,519388.83,Withdrawals & Transfers,ATM & EFTPOS
8/11/2023,Osko Withdrawal               08Nov10:04 Hayley,1000,,521388.83,Withdrawals & Transfers,Withdrawal
8/11/2023,Osko Withdrawal               08Nov00:09 K Bond,1000,,522388.83,Withdrawals & Transfers,Withdrawal
7/11/2023,Visa Purchase                 04Nov Bakery On O'Connell  North Ade,23.13,,523388.83,Food & Beverage,Food & Groceries
7/11/2023,Eftpos Debit                  07Nov08:28 Beem It\,1500,,523411.96,Withdrawals & Transfers,Funds transfer
7/11/2023,Eftpos Debit                  07Nov04:31 Beem It\,40,,524911.96,Withdrawals & Transfers,Funds transfer
7/11/2023,Eftpos Debit                  06Nov14:46 Beem It\,315,,524951.96,Withdrawals & Transfers,Funds transfer
6/11/2023,Raa 35036678_5_1,20.08,,525266.96,Transport & Travel,Vehicle Expenses
6/11/2023,Eftpos Debit                  06Nov09:43 Beem It\,40,,525287.04,Withdrawals & Transfers,Funds transfer
4/11/2023,Osko Withdrawal               04Nov08:30 Airline Ticket Fo Hf Jetstar Airways Pty,50.97,,525327.04,Withdrawals & Transfers,Withdrawal
3/11/2023,Internet Deposit              03Nov19:57 From 9000204517840,,16000,525378.01,Deposits,Deposit
3/11/2023,Atm Withdrawal                03Nov12:46 Banksa                Adelaide     5  Au,600,,509378.01,Withdrawals & Transfers,ATM & EFTPOS
2/11/2023,Rtgs Inward Payment Sgb2311020100811Andrew Ian Maul,,1536.64,509978.01,Deposits,Deposit
1/11/2023,Osko Deposit                  01Nov15:28 2 Out Of 20 Lucas Chapman,,175,508441.37,Deposits,Deposit
31/10/2023,Visa Purchase                 28Oct Bakery On O'Connell  North Ade,17.58,,508266.37,Food & Beverage,Food & Groceries
31/10/2023,Property Managme Rent,,2474,508283.95,Deposits,Deposit
30/10/2023,Raa 33748936_12_1,33.75,,505809.95,Transport & Travel,Vehicle Expenses
30/10/2023,Visa Purchase                 26Oct Bakery On O'Connell  North Ade,30.61,,505843.7,Food & Beverage,Food & Groceries
30/10/2023,Raa 35676928_1_1,18.25,,505874.31,Transport & Travel,Vehicle Expenses
30/10/2023,Eftpos Debit                  30Oct10:30 Ozt*From The Jam - The\,169.75,,505892.56,Entertainment & Recreation,Sports & Leisure
30/10/2023,Eftpos Debit                  29Oct02:47 Beem It\,20,,506062.31,Withdrawals & Transfers,Funds transfer
28/10/2023,Atm Withdrawal                28Oct17:56 Atmx 139 Oconnell St   North Adelaid08Au,1000,,506082.31,Withdrawals & Transfers,ATM & EFTPOS
27/10/2023,Visa Purchase                 25Oct City Bbq & Yum Cha P Rundle Ma,15.6,,507082.31,Food & Beverage,Dining out
27/10/2023,Cardless Atm Withdrawal       27Oct14:06 Banksa                Adelaide Sa  5  Au,500,,507097.91,Withdrawals & Transfers,ATM & EFTPOS
27/10/2023,Tfr Wdl BPAY Internet         27Oct12:24 5092458412          Revsa - Esl,248.55,,507597.91,Bills & Payments,Tax payments
27/10/2023,Tfr Wdl BPAY Internet         27Oct12:22 111534              City Of Adelaide,688.6,,507846.46,Bills & Payments,Tax payments
26/10/2023,Visa Purchase                 24Oct Moshtix Pty Ltd      Sydney,253.8,,508535.06,Entertainment & Recreation,Sports & Leisure
25/10/2023,Medibank Private 108020078433,,146.15,508788.86,Deposits,Insurance
25/10/2023,Atm Withdrawal                25Oct12:32 Rundle Place Os          Adelaide     Au,250,,508642.71,Withdrawals & Transfers,ATM & EFTPOS
24/10/2023,Internet Withdrawal           24Oct13:34 To 9000204517840,1000,,508892.71,Withdrawals & Transfers,Funds transfer
23/10/2023,Allianz Aust 1Rd221368012123296,147.55,,509892.71,Bills & Payments,Insurance
23/10/2023,Allianz Aust 1Rd220985012123296,23.13,,510040.26,Bills & Payments,Insurance
23/10/2023,Eftpos Debit                  23Oct05:11 Beem It\,500,,510063.39,Withdrawals & Transfers,Funds transfer
21/10/2023,Eftpos Debit                  21Oct07:43 Bakery On O'Connell   North Adelaidsa Au,17.88,,510563.39,Food & Beverage,Food & Groceries
21/10/2023,Atm Withdrawal                21Oct07:40 Atmx 139 Oconnell St   North Adelaid08Au,2000,,510581.27,Withdrawals & Transfers,ATM & EFTPOS
20/10/2023,Visa Purchase                 17Oct Governor Hindmarsh H Hindmarsh,22,,512581.27,Food & Beverage,Beverages
20/10/2023,Visa Purchase                 18Oct City Bbq & Yum Cha P Rundle Ma,19.6,,512603.27,Food & Beverage,Dining out
20/10/2023,Atm Withdrawal                20Oct09:47 Banksa                Adelaide Sa  5  Au,300,,512622.87,Withdrawals & Transfers,ATM & EFTPOS
20/10/2023,Eftpos Debit                  19Oct15:53 Beem It\,50,,512922.87,Withdrawals & Transfers,Funds transfer
18/10/2023,Visa Purchase                 15Oct Bakery On O'Connell  North Ade,22.93,,512972.87,Food & Beverage,Food & Groceries
18/10/2023,Osko Deposit                  18Oct20:01 1 Out Of 20 Lucas Chapman,,175,512995.8,Deposits,Deposit
18/10/2023,Eftpos Debit                  18Oct00:03 Beem It\,550,,512820.8,Withdrawals & Transfers,Funds transfer
16/10/2023,American Express 376012649071009,10147.04,,513370.8,Bills & Payments,Expenses & Payments
16/10/2023,Raa 35616154_1_1,78.62,,523517.84,Transport & Travel,Vehicle Expenses
16/10/2023,Loan Repayment S.514.2655406.00,4839,,523596.46,Home & Property,Mortgage & Rent
16/10/2023,Osko Withdrawal               16Oct12:22 Liz,200,,528435.46,Withdrawals & Transfers,Withdrawal
13/10/2023,Property Managme Rent,,1177.9,528635.46,Deposits,Deposit
12/10/2023,Eftpos Debit                  12Oct11:46 Funk Coffee And Foo\Adelaide          Au,11.5,,527457.56,Food & Beverage,Beverages
11/10/2023,Visa Purchase                 10Oct Medibank Phi Debit   Melbourne,560.69,,527469.06,Bills & Payments,Insurance
11/10/2023,Visa Purchase                 08Oct Bakery On O'Connell  North Ade,17.58,,528029.75,Food & Beverage,Food & Groceries
11/10/2023,Eftpos Debit                  11Oct19:35 Beem\\84A06B4Fd53F43Dbafe40F7E6Da5C625,200,,528047.33,Withdrawals & Transfers,Funds transfer
10/10/2023,Visa Purchase                 05Oct Sa Water             Adelaide,339.04,,528247.33,Bills & Payments,Utilities & Rates
10/10/2023,Visa Purchase                 06Oct Bakery On O'Connell  North Ade,14.95,,528586.37,Food & Beverage,Food & Groceries
9/10/2023,Visa Purchase                 05Oct Dit - Ezyreg         Adelaide,197.43,,528601.32,Transport & Travel,Vehicle Expenses
9/10/2023,Visa Purchase                 05Oct Bakery On O'Connell  North Ade,18.79,,528798.75,Food & Beverage,Food & Groceries
9/10/2023,Eftpos Debit                  09Oct07:25 Beem It\,500,,528817.54,Withdrawals & Transfers,Funds transfer
9/10/2023,Eftpos Debit                  09Oct00:57 Beem It\,200,,529317.54,Withdrawals & Transfers,Funds transfer
9/10/2023,Osko Withdrawal               08Oct12:38 Lucas Chapman,3500,,529517.54,Withdrawals & Transfers,Withdrawal
7/10/2023,Osko Withdrawal               07Oct14:06 Hayley,500,,533017.54,Withdrawals & Transfers,Withdrawal
6/10/2023,Raa 35036678_4_1,20.08,,533517.54,Transport & Travel,Vehicle Expenses
5/10/2023,Osko Withdrawal               05Oct13:49 Ada,150,,533537.62,Withdrawals & Transfers,Withdrawal
5/10/2023,Atm Withdrawal                05Oct11:35 Atmx 139 Oconnell St   North Adelaid08Au,2000,,533687.62,Withdrawals & Transfers,ATM & EFTPOS
4/10/2023,Eftpos Debit                  04Oct06:31 Beem It\,100,,535687.62,Withdrawals & Transfers,Funds transfer
3/10/2023,Visa Purchase                 30Sep Bakery On O'Connell  North Ade,24.14,,535787.62,Food & Beverage,Food & Groceries
3/10/2023,Property Managme Rent,,1182.05,535811.76,Deposits,Deposit
2/10/2023,Visa Purchase                 29Sep City Bbq & Yum Cha P Rundle Ma,22.6,,534629.71,Food & Beverage,Dining out
2/10/2023,Internet Deposit              02Oct11:52 From 9000204517840,,6000,534652.31,Deposits,Deposit
29/09/2023,Raa 33748936_11_1,33.75,,528652.31,Transport & Travel,Vehicle Expenses
29/09/2023,Raa 33564303_12_1,16.58,,528686.06,Transport & Travel,Vehicle Expenses
29/09/2023,Eftpos Debit                  29Sep08:50 Beem It\,200,,528702.64,Withdrawals & Transfers,Funds transfer
29/09/2023,Eftpos Debit                  29Sep06:05 Beem It\,100,,528902.64,Withdrawals & Transfers,Funds transfer
28/09/2023,Atm Withdrawal                28Sep08:48 Atmx 139 Oconnell St   North Adelaid08Au,950,,529002.64,Withdrawals & Transfers,ATM & EFTPOS
26/09/2023,Visa Purchase                 23Sep Pasta Go Go North Ad North Ade,13.4,,529952.64,Food & Beverage,Dining out
26/09/2023,Visa Purchase                 23Sep Bakery On O'Connell  North Ade,11.11,,529966.04,Food & Beverage,Food & Groceries
26/09/2023,Eftpos Debit                  26Sep01:33 Beem It\,100,,529977.15,Withdrawals & Transfers,Funds transfer
25/09/2023,Visa Purchase                 22Sep City Bbq & Yum Cha P Rundle Ma,19.8,,530077.15,Food & Beverage,Dining out
23/09/2023,Visa Purchase                 21Sep Bws/123 Oconnell Str Nrth Adel,25,,530096.95,Food & Beverage,Beverages
23/09/2023,Visa Purchase                 20Sep Bakery On O'Connell  North Ade,11.82,,530121.95,Food & Beverage,Food & Groceries
23/09/2023,Eftpos Debit                  23Sep09:30 Beem It\,200,,530133.77,Withdrawals & Transfers,Funds transfer
21/09/2023,Foreign Currency Conversn Fee,11.55,,530333.77,Fees & Charges,Fees & Charges
21/09/2023,Visa Purchase O/Seas          19Sep Usd247.13 Seeedstudio,385.24,,530345.32,Home & Property,Technology & Appliances
21/09/2023,Allianz Aust 1Rd221368018323264,147.55,,530730.56,Bills & Payments,Insurance
21/09/2023,Allianz Aust 1Rd220985018323264,23.13,,530878.11,Bills & Payments,Insurance
21/09/2023,Atm Withdrawal                20Sep21:42 Atmx 139 Oconnell St   North Adelaid08Au,2000,,530901.24,Withdrawals & Transfers,ATM & EFTPOS
20/09/2023,Visa Purchase                 17Sep Bakery On O'Connell  North Ade,21.21,,532901.24,Food & Beverage,Food & Groceries
20/09/2023,Eftpos Debit                  19Sep23:48 Beem It\,100,,532922.45,Withdrawals & Transfers,Funds transfer
18/09/2023,Annual Package Fee  506149558 Advantage,395,,533022.45,Fees & Charges,Fees & Charges
18/09/2023,Tfr Wdl BPAY Internet         18Sep15:03 4601843800646786    Banksa Cards,6674.15,,533417.45,Withdrawals & Transfers,Withdrawal
18/09/2023,Eftpos Debit                  18Sep04:09 Beem It\,250,,540091.6,Withdrawals & Transfers,Funds transfer
16/09/2023,Visa Purchase                 13Sep Epicure Paradise Pl  Adelaide,16,,540341.6,Food & Beverage,Dining out
16/09/2023,Visa Purchase                 14Sep Bread Temptation     Adelaide,8.6,,540357.6,Food & Beverage,Food & Groceries
16/09/2023,Loan Repayment S.514.2655406.00,5149,,540366.2,Home & Property,Mortgage & Rent
16/09/2023,Eftpos Debit                  16Sep03:30 Beem It\,100,,545515.2,Withdrawals & Transfers,Funds transfer
15/09/2023,Visa Purchase                 12Sep Bakery On O'Connell  North Ade,18.59,,545615.2,Food & Beverage,Food & Groceries
15/09/2023,Property Managme Rent,,1199.9,545633.79,Deposits,Deposit
15/09/2023,Osko Withdrawal               15Sep16:32 Hayley,270,,544433.89,Withdrawals & Transfers,Withdrawal
14/09/2023,Raa 33512344_12_1,70.66,,544703.89,Transport & Travel,Vehicle Expenses
14/09/2023,Visa Purchase                 11Sep Bakery On O'Connell  North Ade,17.58,,544774.55,Food & Beverage,Food & Groceries
14/09/2023,Visa Purchase                 12Sep Cafe Komodo          Prospect,15.98,,544792.13,Food & Beverage,Dining out
12/09/2023,Visa Purchase                 11Sep Medibank Phi Debit   Melbourne,560.69,,544808.11,Bills & Payments,Insurance
11/09/2023,Visa Purchase                 08Sep City Bbq & Yum Cha P Rundle Ma,19.6,,545368.8,Food & Beverage,Dining out
11/09/2023,Osko Deposit                  11Sep15:27 Tyres Lucas Chapman,,1500,545388.4,Deposits,Deposit
11/09/2023,Eftpos Debit                  11Sep04:02 Beem It\,400,,543888.4,Withdrawals & Transfers,Funds transfer
9/09/2023,Eftpos Debit                  09Sep02:08 Beem It\,200,,544288.4,Withdrawals & Transfers,Funds transfer
6/09/2023,Raa 35036678_3_1,20.08,,544488.4,Transport & Travel,Vehicle Expenses
4/09/2023,Visa Purchase                 01Sep Eventbookings Pty Lt Geelong,90,,544508.48,Bills & Payments,Expenses & Payments
4/09/2023,Visa Purchase                 01Sep City Bbq & Yum Cha P Rundle Ma,12,,544598.48,Food & Beverage,Dining out
4/09/2023,Internet Deposit              04Sep14:40 From 9000204517840,,17000,544610.48,Deposits,Deposit
1/09/2023,American Express 376012649071009,19949.88,,527610.48,Bills & Payments,Expenses & Payments
1/09/2023,Visa Purchase                 30Aug Shijia Service Pty L Adelaide,12.37,,547560.36,Food & Beverage,Food & Groceries
31/08/2023,Visa Purchase                 29Aug Banxa Bitcoi 1068939 Www.Bitco,1700,,547572.73,Withdrawals & Transfers,Funds transfer
31/08/2023,Property Managme Rent,,1199.9,549272.73,Deposits,Deposit
30/08/2023,Visa Purchase                 28Aug Bakery On O Connell  North Ade,17.4,,548072.83,Food & Beverage,Food & Groceries
30/08/2023,Atm Withdrawal                30Aug13:34 Rundle Place Os          Adelaide     Au,2000,,548090.23,Withdrawals & Transfers,ATM & EFTPOS
30/08/2023,Eftpos Debit                  30Aug13:23 City Bbq & Yum Cha P  Rundle Mall  Sa Au,19.6,,550090.23,Food & Beverage,Dining out
30/08/2023,Osko Withdrawal               30Aug13:24 Hayley,1000,,550109.83,Withdrawals & Transfers,Withdrawal
29/08/2023,Raa 33748936_10_1,33.75,,551109.83,Transport & Travel,Vehicle Expenses
29/08/2023,Raa 33564303_11_1,16.58,,551143.58,Transport & Travel,Vehicle Expenses
29/08/2023,Cardless Atm Withdrawal       29Aug08:05 Westpac               Southport    4  Au,500,,551160.16,Withdrawals & Transfers,ATM & EFTPOS
28/08/2023,Atm Withdrawal                28Aug14:21 Atmx 139 Oconnell St   North Adelaid08Au,2000,,551660.16,Withdrawals & Transfers,ATM & EFTPOS
28/08/2023,Cardless Atm Withdrawal       28Aug08:36 Westpac               Runaway Bay  4  Au,500,,553660.16,Withdrawals & Transfers,ATM & EFTPOS
23/08/2023,Osko Deposit                  23Aug12:31 Lucas Chapman,,250,554160.16,Deposits,Deposit
22/08/2023,Osko Withdrawal               22Aug00:17 Michelle,2000,,553910.16,Withdrawals & Transfers,Withdrawal
21/08/2023,Allianz Aust 1Rd221368015023233,147.55,,555910.16,Bills & Payments,Insurance
21/08/2023,Allianz Aust 1Rd220985015023233,23.13,,556057.71,Bills & Payments,Insurance
19/08/2023,Internet Deposit              18Aug22:59 From 9000204517840,,3000,556080.84,Deposits,Deposit
18/08/2023,Osko Deposit                  18Aug15:13 Loan Lucas Chapman,,250,553080.84,Deposits,Deposit
16/08/2023,Loan Repayment S.514.2655406.00,5039,,552830.84,Home & Property,Mortgage & Rent
15/08/2023,Property Managme Rent,,1056.9,557869.84,Deposits,Deposit
15/08/2023,Osko Withdrawal               14Aug22:21 98764 Full Payment Of Invoice Thg Electr,329.35,,556812.94,Withdrawals & Transfers,Withdrawal
14/08/2023,Raa 33512344_11_1,70.66,,557142.29,Transport & Travel,Vehicle Expenses
11/08/2023,Visa Purchase                 10Aug Medibank Phi Debit   Melbourne,560.69,,557212.95,Bills & Payments,Insurance
9/08/2023,Visa Purchase                 04Aug The Earl Of Aberdeen Adelaide,10,,557773.64,Food & Beverage,Beverages
8/08/2023,Visa Purchase                 05Aug Bakery On O'Connell  North Ade,17.4,,557783.64,Food & Beverage,Food & Groceries
7/08/2023,Visa Purchase                 04Aug Centre Com Sunshine  Adelaide,171.03,,557801.04,Home & Property,Technology & Appliances
7/08/2023,Raa 35036678_2_1,20.08,,557972.07,Transport & Travel,Vehicle Expenses
7/08/2023,Osko Withdrawal               06Aug14:05 K Bond,900,,557992.15,Withdrawals & Transfers,Withdrawal
5/08/2023,Visa Purchase                 02Aug Sa Water             Adelaide,335.58,,558892.15,Bills & Payments,Utilities & Rates
5/08/2023,Visa Purchase                 02Aug Bakery On O'Connell  North Ade,17.4,,559227.73,Food & Beverage,Food & Groceries
5/08/2023,Visa Purchase                 02Aug Ezymart 118 K W S Pl Adelaide,5.5,,559245.13,Food & Beverage,Food & Groceries
4/08/2023,Visa Purchase                 01Aug North Adelaide News  North Ade,5.99,,559250.63,Entertainment & Recreation,Books & Subscriptions
4/08/2023,Atm Withdrawal                04Aug16:06 Atmx 139 Oconnell St   North Adelaid08Au,2000,,559256.62,Withdrawals & Transfers,ATM & EFTPOS
4/08/2023,Tfr Wdl BPAY Internet         04Aug12:02 4601843800646786    Banksa Cards,5000,,561256.62,Withdrawals & Transfers,Withdrawal
4/08/2023,Osko Withdrawal               04Aug09:07 K Bond,400,,566256.62,Withdrawals & Transfers,Withdrawal
3/08/2023,Visa Purchase                 01Aug Sq *Village Asian Gr North Ade,10.7,,566656.62,Food & Beverage,Food & Groceries
2/08/2023,Visa Purchase                 30Jul Bakery On O'Connell  North Ade,29.3,,566667.32,Food & Beverage,Food & Groceries
1/08/2023,Visa Purchase                 28Jul Bakery On O'Connell  North Ade,30.3,,566696.62,Food & Beverage,Food & Groceries
1/08/2023,Visa Purchase                 29Jul Bakery On O'Connell  North Ade,17.4,,566726.92,Food & Beverage,Food & Groceries
1/08/2023,Eftpos Debit                  31Jul17:38 Beem It\,200,,566744.32,Withdrawals & Transfers,Funds transfer
31/07/2023,Raa 33748936_9_1,33.75,,566944.32,Transport & Travel,Vehicle Expenses
31/07/2023,Raa 33564303_10_1,16.58,,566978.07,Transport & Travel,Vehicle Expenses
31/07/2023,Property Managme Rent,,1274.1,566994.65,Deposits,Deposit
31/07/2023,Osko Withdrawal               31Jul17:52 Hayley,2280.45,,565720.55,Withdrawals & Transfers,Withdrawal
31/07/2023,Osko Withdrawal               30Jul12:53 Hayley,5000,,568001,Withdrawals & Transfers,Withdrawal
29/07/2023,Visa Purchase                 26Jul Bakery On O'Connell  North Ade,17.4,,573001,Food & Beverage,Food & Groceries
29/07/2023,Atm Withdrawal                29Jul20:56 Atmx 139 Oconnell St   North Adelaid08Au,2000,,573018.4,Withdrawals & Transfers,ATM & EFTPOS
29/07/2023,Osko Withdrawal               29Jul18:32 Lucas Chapman,1700,,575018.4,Withdrawals & Transfers,Withdrawal
29/07/2023,Osko Withdrawal               29Jul16:22 Lucas Chapman,200,,576718.4,Withdrawals & Transfers,Withdrawal
28/07/2023,Visa Purchase                 26Jul City Bbq & Yum Cha P Rundle Ma,21.6,,576918.4,Food & Beverage,Dining out
27/07/2023,Visa Purchase                 24Jul Bakery On O'Connell  North Ade,22.9,,576940,Food & Beverage,Food & Groceries
27/07/2023,Eftpos Debit                  26Jul15:02 Beem It\,200,,576962.9,Withdrawals & Transfers,Funds transfer
26/07/2023,Visa Purchase                 23Jul Smp*The Flying Fig   North Ade,13.6,,577162.9,Food & Beverage,Food & Groceries
26/07/2023,Tfr Wdl BPAY Internet         26Jul05:47 4601843800646786    Banksa Cards,500,,577176.5,Withdrawals & Transfers,Withdrawal
25/07/2023,Visa Purchase                 21Jul Bakery On O'Connell  North Ade,29.7,,577676.5,Food & Beverage,Food & Groceries
25/07/2023,Visa Purchase                 21Jul Smp*Cheekies On Piri Adelaide,22.36,,577706.2,Food & Beverage,Dining out
24/07/2023,Visa Purchase                 20Jul Bakery On O'Connell  North Ade,17.4,,577728.56,Food & Beverage,Food & Groceries
24/07/2023,Visa Purchase                 21Jul Bread Temptation     Adelaide,12.3,,577745.96,Food & Beverage,Food & Groceries
22/07/2023,Visa Purchase                 19Jul Bakery On O'Connell  North Ade,17.4,,577758.26,Food & Beverage,Food & Groceries
21/07/2023,Allianz Aust 1Rd221368011523202,147.55,,577775.66,Bills & Payments,Insurance
21/07/2023,Allianz Aust 1Rd220985011523202,23.13,,577923.21,Bills & Payments,Insurance
21/07/2023,Osko Deposit                  21Jul15:51 Mrs Michelle Ann Russell,,50,577946.34,Deposits,Deposit
20/07/2023,Visa Purchase                 17Jul Bakery On O'Connell  North Ade,5.5,,577896.34,Food & Beverage,Food & Groceries
20/07/2023,Eftpos Debit                  20Jul08:57 Beem It\,100,,577901.84,Withdrawals & Transfers,Funds transfer
20/07/2023,Eftpos Debit                  20Jul04:02 Beem It\,80,,578001.84,Withdrawals & Transfers,Funds transfer
19/07/2023,Visa Purchase                 16Jul Bakery On O'Connell  North Ade,16.4,,578081.84,Food & Beverage,Food & Groceries
19/07/2023,Cash Withdrawal,2000,,578098.24,Withdrawals & Transfers,Withdrawal
19/07/2023,Eftpos Debit                  18Jul12:36 Beem It\,100,,580098.24,Withdrawals & Transfers,Funds transfer
18/07/2023,Eftpos Debit                  18Jul15:36 Ozt*Wheres The Pope?\,101.75,,580198.24,Entertainment & Recreation,Sports & Leisure
18/07/2023,Osko Withdrawal               18Jul14:57 155092 Order Ref  155092 Ozsmoke,340.96,,580299.99,Withdrawals & Transfers,Withdrawal
17/07/2023,American Express 376012649071009,25471.73,,580640.95,Bills & Payments,Expenses & Payments
17/07/2023,Visa Purchase                 13Jul Bakery On O'Connell  North Ade,14.5,,606112.68,Food & Beverage,Food & Groceries
17/07/2023,Eftpos Debit                  17Jul03:35 Beem It\,100,,606127.18,Withdrawals & Transfers,Funds transfer
17/07/2023,Osko Withdrawal               17Jul11:09 Hayley,2600,,606227.18,Withdrawals & Transfers,Withdrawal
17/07/2023,Loan Repayment S.514.2655406.00,4921,,608827.18,Home & Property,Mortgage & Rent
17/07/2023,Eftpos Debit                  16Jul04:38 Beem It\,50,,613748.18,Withdrawals & Transfers,Funds transfer
17/07/2023,Osko Withdrawal               16Jul12:24 Hayley,200,,613798.18,Withdrawals & Transfers,Withdrawal
14/07/2023,Raa 33512344_10_1,70.66,,613998.18,Transport & Travel,Vehicle Expenses
14/07/2023,Visa Purchase                 11Jul Bakery On O'Connell  North Ade,17.9,,614068.84,Food & Beverage,Food & Groceries
14/07/2023,Property Managme Rent,,1199.9,614086.74,Deposits,Deposit
14/07/2023,Eftpos Debit                  14Jul07:23 Beem It\,300,,612886.84,Withdrawals & Transfers,Funds transfer
13/07/2023,Osko Withdrawal               13Jul13:37 Hayley,260,,613186.84,Withdrawals & Transfers,Withdrawal
11/07/2023,Visa Purchase                 10Jul Medibank Phi Debit   Melbourne,560.69,,613446.84,Bills & Payments,Insurance
11/07/2023,Atm Withdrawal                11Jul11:09 Rundle Place Os          Adelaide     Au,2000,,614007.53,Withdrawals & Transfers,ATM & EFTPOS
10/07/2023,Visa Purchase                 07Jul City Bbq & Yum Cha P Rundle Ma,18,,616007.53,Food & Beverage,Dining out
10/07/2023,Visa Purchase                 06Jul Ezymart 118 K W S Pl Adelaide,12.78,,616025.53,Food & Beverage,Food & Groceries
7/07/2023,Internet Withdrawal           07Jul20:28 To 9000204517840,2000,,616038.31,Withdrawals & Transfers,Funds transfer
7/07/2023,Internet Withdrawal           07Jul20:28 To 0280074830940,5000,,618038.31,Withdrawals & Transfers,Funds transfer
7/07/2023,Eftpos Debit                  07Jul08:56 Funk Coffee And Foo\Adelaide          Au,5,,623038.31,Food & Beverage,Beverages
6/07/2023,Raa 35036678_1_1,20.12,,623043.31,Transport & Travel,Vehicle Expenses
6/07/2023,Visa Purchase                 03Jul City Bbq & Yum Cha P Rundle Ma,14.4,,623063.43,Food & Beverage,Dining out
5/07/2023,Visa Purchase                 04Jul Peter Stevens Mcycle Adelaide,169,,623077.83,Transport & Travel,Vehicle Expenses
5/07/2023,Hub24 Custodial Hub24-24045332,,370474.99,623246.83,Deposits,Deposit
4/07/2023,Visa Purchase                 01Jul Bakery On O'Connell  North Ade,19,,252771.84,Food & Beverage,Food & Groceries
4/07/2023,Osko Withdrawal               04Jul00:15 153891 For Order 153891 Ozsmoke,111.1,,252790.84,Withdrawals & Transfers,Withdrawal
3/07/2023,Eftpos Debit                  02Jul08:23 Beem It\,100,,252901.94,Withdrawals & Transfers,Funds transfer
1/07/2023,Visa Purchase                 28Jun Bakery On O'Connell  North Ade,17.4,,253001.94,Food & Beverage,Food & Groceries
1/07/2023,Osko Withdrawal               01Jul14:58 K Bond,50,,253019.34,Withdrawals & Transfers,Withdrawal
1/07/2023,Osko Deposit                  01Jul12:40 Mrs Michelle Ann Russell,,25,253069.34,Deposits,Deposit
30/06/2023,Visa Purchase                 27Jun Bakery On O'Connell  North Ade,17.4,,253044.34,Food & Beverage,Food & Groceries
29/06/2023,Raa 33748936_8_1,33.75,,253061.74,Transport & Travel,Vehicle Expenses
29/06/2023,Raa 33564303_9_1,16.58,,253095.49,Transport & Travel,Vehicle Expenses
29/06/2023,Visa Purchase                 23Jun Ezymart 118 K W S Pl Adelaide,12.29,,253112.07,Food & Beverage,Food & Groceries
29/06/2023,Visa Purchase                 27Jun City Bbq & Yum Cha P Rundle Ma,9.2,,253124.36,Food & Beverage,Dining out
29/06/2023,Osko Deposit                  29Jun10:55 Mrs Michelle Ann Russell,,50,253133.56,Deposits,Deposit
28/06/2023,Osko Deposit                  28Jun12:53 Lucas Chapman,,750,253083.56,Deposits,Deposit
27/06/2023,Visa Purchase                 23Jun Bakery On O'Connell  North Ade,17.4,,252333.56,Food & Beverage,Food & Groceries
27/06/2023,Atm Withdrawal                27Jun17:06 Banksa                Adelaide     5  Au,200,,252350.96,Withdrawals & Transfers,ATM & EFTPOS
26/06/2023,Osko Withdrawal               26Jun12:33 Michelle,50,,252550.96,Withdrawals & Transfers,Withdrawal
26/06/2023,Tfr Wdl BPAY Internet         26Jun05:42 4601843800646786    Banksa Cards,500,,252600.96,Withdrawals & Transfers,Withdrawal
24/06/2023,Atm Withdrawal -Wbc           24Jun11:18 Westpac               Prospect     5  Au,2000,,253100.96,Withdrawals & Transfers,ATM & EFTPOS
24/06/2023,Osko Withdrawal               24Jun09:56 Deposit J M Mccassey,50,,255100.96,Withdrawals & Transfers,Withdrawal
23/06/2023,Visa Purchase                 15Jun Spotto Qld           Darlinghu,32.07,,255150.96,Transport & Travel,Taxi & Rental car
23/06/2023,Visa Purchase                 21Jun Upk Wyatt            Adelaide,31,,255183.03,Bills & Payments,Professional & Govt services
23/06/2023,Visa Purchase                 14Jun Bakery On O'Connell  North Ade,18.9,,255214.03,Food & Beverage,Food & Groceries
23/06/2023,Visa Purchase                 20Jun Bakery On O'Connell  North Ade,17.4,,255232.93,Food & Beverage,Food & Groceries
23/06/2023,Visa Purchase                 21Jun Adelaide Airport Lim Adeladie,12,,255250.33,Transport & Travel,Air Travel
23/06/2023,Atm Withdrawal                23Jun14:27 Banksa                Adelaide Sa  5  Au,1500,,255262.33,Withdrawals & Transfers,ATM & EFTPOS
23/06/2023,Cardless Atm Withdrawal       23Jun14:26 Banksa                Adelaide Sa  5  Au,500,,256762.33,Withdrawals & Transfers,ATM & EFTPOS
23/06/2023,Eftpos Debit                  23Jun00:11 Beem It\,500,,257262.33,Withdrawals & Transfers,Funds transfer
23/06/2023,Osko Withdrawal               23Jun09:51 Hayley,1147.5,,257762.33,Withdrawals & Transfers,Withdrawal
23/06/2023,Eftpos Debit                  23Jun08:47 Funk Coffee And Foo\Adelaide          Au,11.5,,258909.83,Food & Beverage,Beverages
23/06/2023,Osko Deposit                  22Jun22:10 Lucas Chapman,,750,258921.33,Deposits,Deposit
22/06/2023,Visa Purchase                 20Jun Sq *Village Asian Gr North Ade,16.6,,258171.33,Food & Beverage,Food & Groceries
22/06/2023,Osko Deposit                  22Jun22:05 Lucas Chapman,,1,258187.93,Deposits,Deposit
22/06/2023,Eftpos Debit                  22Jun06:35 Beem It\,500,,258186.93,Withdrawals & Transfers,Funds transfer
22/06/2023,Cardless Atm Withdrawal       22Jun09:48 Westpac               Prospect     5  Au,500,,258686.93,Withdrawals & Transfers,ATM & EFTPOS
21/06/2023,Allianz Aust 1Rd221368017823172,147.55,,259186.93,Bills & Payments,Insurance
21/06/2023,Allianz Aust 1Rd220985017823172,23.13,,259334.48,Bills & Payments,Insurance
21/06/2023,Visa Purchase                 19Jun St Georges Bakehouse North Ade,11.1,,259357.61,Food & Beverage,Dining out
21/06/2023,Osko Deposit                  21Jun14:39 Mrs Michelle Ann Russell,,50,259368.71,Deposits,Deposit
20/06/2023,Atm Withdrawal                20Jun17:11 Atmx 139 Oconnell St   North Adelaid08Au,2000,,259318.71,Withdrawals & Transfers,ATM & EFTPOS
20/06/2023,Osko Withdrawal               20Jun14:57 Hayley,500,,261318.71,Withdrawals & Transfers,Withdrawal
19/06/2023,Osko Withdrawal               19Jun14:52 Michelle,50,,261818.71,Withdrawals & Transfers,Withdrawal
19/06/2023,Eftpos Debit                  18Jun02:48 Beem It\,500,,261868.71,Withdrawals & Transfers,Funds transfer
16/06/2023,Loan Repayment S.514.2655406.00,4921,,262368.71,Home & Property,Mortgage & Rent
16/06/2023,Osko Withdrawal               16Jun17:30 Lucas Chapman,1490,,267289.71,Withdrawals & Transfers,Withdrawal
16/06/2023,Osko Withdrawal               16Jun17:24 Lucas Chapman,10,,268779.71,Withdrawals & Transfers,Withdrawal
15/06/2023,Visa Purchase                 13Jun 1 Office Account     Adelaide,110,,268789.71,Bills & Payments,Legal & Financial services
15/06/2023,Visa Purchase                 13Jun Pasta Go Go North Ad North Ade,15.4,,268899.71,Food & Beverage,Dining out
15/06/2023,Property Managme Rent,,437.68,268915.11,Deposits,Deposit
14/06/2023,Raa 33512344_9_1,70.66,,268477.43,Transport & Travel,Vehicle Expenses
13/06/2023,American Express 376012649071009,11140.33,,268548.09,Bills & Payments,Expenses & Payments
13/06/2023,Visa Purchase                 12Jun Medibank Phi Debit   Melbourne,560.69,,279688.42,Bills & Payments,Insurance
13/06/2023,Atm Withdrawal                13Jun15:43 Atmx 139 Oconnell St   North Adelaid08Au,600,,280249.11,Withdrawals & Transfers,ATM & EFTPOS
12/06/2023,Eftpos Debit                  11Jun13:56 Beem It\,1500,,280849.11,Withdrawals & Transfers,Funds transfer
12/06/2023,Osko Withdrawal               11Jun16:18 Michelle,100,,282349.11,Withdrawals & Transfers,Withdrawal
10/06/2023,Visa Purchase                 08Jun Ndc Service Co Pty L North Ade,4545,,282449.11,Retail & Personal,Medical & Personal care
10/06/2023,Visa Purchase                 08Jun City Bbq & Yum Cha P Rundle Ma,18,,286994.11,Food & Beverage,Dining out
10/06/2023,Osko Withdrawal               10Jun17:04 K Bond,1200,,287012.11,Withdrawals & Transfers,Withdrawal
10/06/2023,Osko Deposit                  10Jun02:19 Mrs Michelle Ann Russell,,50,288212.11,Deposits,Deposit
9/06/2023,Atm Withdrawal                09Jun15:23 Atmx 139 Oconnell St   North Adelaid08Au,2000,,288162.11,Withdrawals & Transfers,ATM & EFTPOS
8/06/2023,Visa Purchase                 06Jun Ndc Service Co Pty L North Ade,125,,290162.11,Retail & Personal,Medical & Personal care
8/06/2023,Visa Purchase                 06Jun Bakery On O'Connell  North Ade,17.7,,290287.11,Food & Beverage,Food & Groceries
8/06/2023,Atm Withdrawal                08Jun14:01 Rundle Place Os          Adelaide     Au,2000,,290304.81,Withdrawals & Transfers,ATM & EFTPOS
7/06/2023,Osko Deposit                  07Jun16:24 Mrs Michelle Ann Russell,,100,292304.81,Deposits,Deposit
6/06/2023,Raa 32276905_12_1,20.83,,292204.81,Transport & Travel,Vehicle Expenses
6/06/2023,Visa Purchase                 03Jun Bakery On O'Connell  North Ade,18.1,,292225.64,Food & Beverage,Food & Groceries
6/06/2023,Eftpos Debit                  05Jun12:49 Beem It\,500,,292243.74,Withdrawals & Transfers,Funds transfer
5/06/2023,Osko Withdrawal               04Jun16:12 Michelle,100,,292743.74,Withdrawals & Transfers,Withdrawal
5/06/2023,Internet Deposit              04Jun16:06 From 9000204517840,,15000,292843.74,Deposits,Deposit
3/06/2023,Visa Purchase                 31May Bakery On O'Connell  North Ade,22.9,,277843.74,Food & Beverage,Food & Groceries
1/06/2023,Tfr Wdl BPAY Internet         01Jun06:14 111534              City Of Adelaide,614.9,,277866.64,Bills & Payments,Tax payments
1/06/2023,Tfr Wdl BPAY Internet         01Jun06:14 440057              City Of Adelaide,538.75,,278481.54,Bills & Payments,Tax payments
31/05/2023,Visa Purchase                 29May Adelaide Health Care Adelaide,86.35,,279020.29,Retail & Personal,Medical & Personal care
31/05/2023,Property Managme Rent,,2399.8,279106.64,Deposits,Deposit
30/05/2023,Visa Purchase                 26May Bakery On O'Connell  North Ade,23.9,,276706.84,Food & Beverage,Food & Groceries
29/05/2023,Raa 33748936_7_1,33.75,,276730.74,Transport & Travel,Vehicle Expenses
29/05/2023,Visa Purchase                 25May Bakery On O'Connell  North Ade,18.6,,276764.49,Food & Beverage,Food & Groceries
29/05/2023,Visa Purchase                 26May City Bbq & Yum Cha P Rundle Ma,18,,276783.09,Food & Beverage,Dining out
29/05/2023,Raa 33564303_8_1,16.58,,276801.09,Transport & Travel,Vehicle Expenses
29/05/2023,Visa Purchase                 26May Shijia Service Pty L Adelaide,11.3,,276817.67,Food & Beverage,Food & Groceries
29/05/2023,Medibank Private 650019468241,,239.05,276828.97,Deposits,Insurance
29/05/2023,Mcare Benefits 572162504 Gywq,,39.75,276589.92,Government payments,Centrelink payments
29/05/2023,Osko Withdrawal               29May13:53 Michelle,100,,276550.17,Withdrawals & Transfers,Withdrawal
27/05/2023,Visa Purchase                 24May Bakery On O'Connell  North Ade,5.5,,276650.17,Food & Beverage,Food & Groceries
26/05/2023,Visa Purchase                 23May Bakery On O'Connell  North Ade,10.5,,276655.67,Food & Beverage,Food & Groceries
26/05/2023,Visa Purchase                 24May Sq *Village Asian Gr North Ade,5.4,,276666.17,Food & Beverage,Food & Groceries
26/05/2023,Visa Purchase                 24May Bakers Delight       North Ade,3.5,,276671.57,Food & Beverage,Food & Groceries
26/05/2023,Tfr Wdl BPAY Internet         26May06:07 4601843800646786    Banksa Cards,500,,276675.07,Withdrawals & Transfers,Withdrawal
25/05/2023,Atm Withdrawal                25May09:27 Atmx 139 Oconnell St   North Adelaid08Au,1550,,277175.07,Withdrawals & Transfers,ATM & EFTPOS
24/05/2023,Atm Withdrawal                24May09:29 Rundle Place Os          Adelaide     Au,2000,,278725.07,Withdrawals & Transfers,ATM & EFTPOS
22/05/2023,Visa Purchase                 19May Ndc Service Co Pty L North Ade,567,,280725.07,Retail & Personal,Medical & Personal care
22/05/2023,Allianz Aust 1Rd221368014623142,147.55,,281292.07,Bills & Payments,Insurance
22/05/2023,Allianz Aust 1Rd220985014623142,23.13,,281439.62,Bills & Payments,Insurance
22/05/2023,Osko Withdrawal               22May19:40 Ada Oliver Dearman,100,,281462.75,Withdrawals & Transfers,Withdrawal
20/05/2023,Visa Purchase                 17May Bakery On O'Connell  North Ade,18,,281562.75,Food & Beverage,Food & Groceries
16/05/2023,Visa Purchase                 13May Bakery On O'Connell  North Ade,21.8,,281580.75,Food & Beverage,Food & Groceries
16/05/2023,Loan Repayment S.514.2655406.00,4808,,281602.55,Home & Property,Mortgage & Rent
15/05/2023,American Express 376012649071009,18534.88,,286410.55,Bills & Payments,Expenses & Payments
15/05/2023,Raa 33512344_8_1,70.66,,304945.43,Transport & Travel,Vehicle Expenses
15/05/2023,Property Managme Rent,,1199.9,305016.09,Deposits,Deposit
13/05/2023,Visa Purchase                 10May Bakery On O'Connell  North Ade,17.2,,303816.19,Food & Beverage,Food & Groceries
12/05/2023,Tfr Wdl BPAY Internet         12May06:05 001608865433292360  Tax Office Payments,500,,303833.39,Bills & Payments,Tax payments
11/05/2023,Visa Purchase                 10May Medibank Phi Debit   Melbourne,543.35,,304333.39,Bills & Payments,Insurance
11/05/2023,Osko Withdrawal               11May16:13 Happy Birthday Hayley,1500,,304876.74,Withdrawals & Transfers,Withdrawal
10/05/2023,Osko Deposit                  10May18:10 Mrs Michelle Ann Russell,,175,306376.74,Deposits,Deposit
9/05/2023,Atm Withdrawal                09May15:30 Rundle Place Os          Adelaide     Au,1000,,306201.74,Withdrawals & Transfers,ATM & EFTPOS
8/05/2023,Raa 32276905_11_1,20.83,,307201.74,Transport & Travel,Vehicle Expenses
8/05/2023,Visa Purchase                 04May Bakery On O'Connell  North Ade,17,,307222.57,Food & Beverage,Food & Groceries
8/05/2023,Atm Withdrawal                07May14:10 Atmx 139 Oconnell St   North Adelaid08Au,2000,,307239.57,Withdrawals & Transfers,ATM & EFTPOS
5/05/2023,Osko Deposit                  05May11:46 Me  Mrs Michelle Ann Russell,,150,309239.57,Deposits,Deposit
3/05/2023,Atm Withdrawal                03May14:15 Banksa                Adelaide Sa  5  Au,2000,,309089.57,Withdrawals & Transfers,ATM & EFTPOS
2/05/2023,Internet Deposit              02May12:08 From 0280074830940,,95000,311089.57,Deposits,Deposit
1/05/2023,Raa 33748936_6_1,33.75,,216089.57,Transport & Travel,Vehicle Expenses
1/05/2023,Raa 33564303_7_1,16.58,,216123.32,Transport & Travel,Vehicle Expenses
1/05/2023,Atm Withdrawal                01May16:59 Atmx 139 Oconnell St   North Adelaid08Au,2000,,216139.9,Withdrawals & Transfers,ATM & EFTPOS
29/04/2023,Internet Deposit              29Apr22:09 From 9000204517840,,22000,218139.9,Deposits,Deposit
29/04/2023,Osko Withdrawal               29Apr16:52 Andrew K Bond,600,,196139.9,Withdrawals & Transfers,Withdrawal
29/04/2023,Atm Withdrawal                29Apr16:17 Banksa                Adelaide     5  Au,1500,,196739.9,Withdrawals & Transfers,ATM & EFTPOS
28/04/2023,Property Managme Rent,,1144.52,198239.9,Deposits,Deposit
28/04/2023,Tfr Wdl BPAY Internet         27Apr23:58 4601843800646786    Banksa Cards,2000,,197095.38,Withdrawals & Transfers,Withdrawal
27/04/2023,Visa Purchase                 21Apr Metro Oyster Bar P/L Adelaide,117.4,,199095.38,Food & Beverage,Dining out
27/04/2023,Visa Purchase                 24Apr Bakery On O'Connell  North Ade,12.2,,199212.78,Food & Beverage,Food & Groceries
27/04/2023,Visa Purchase                 21Apr Crown And Anchor     Adelaide,9,,199224.98,Transport & Travel,Hotels and Accommodation
24/04/2023,Visa Purchase                 20Apr All Day Stores Pty L Adelaide,44.45,,199233.98,Food & Beverage,Food & Groceries
24/04/2023,Osko Deposit                  24Apr18:11 Mrs Michelle Ann Russell,,120,199278.43,Deposits,Deposit
24/04/2023,Osko Withdrawal               23Apr15:03 148976 Payment For Order Numbe Ozsmoke,162.6,,199158.43,Withdrawals & Transfers,Withdrawal
22/04/2023,Visa Purchase                 20Apr Sq *Daily Planet Ade Adelaide,4.6,,199321.03,Food & Beverage,Dining out
21/04/2023,Allianz Aust 1Rd221368011123111,147.55,,199325.63,Bills & Payments,Insurance
21/04/2023,Allianz Aust 1Rd220985011123111,23.13,,199473.18,Bills & Payments,Insurance
21/04/2023,Medibank Private 650019248164,,68.1,199496.31,Deposits,Insurance
21/04/2023,Osko Deposit                  21Apr10:17 Mrs Michelle Ann Russell,,200,199428.21,Deposits,Deposit
20/04/2023,Atm Withdrawal                20Apr14:28 Banksa                Adelaide Sa  5  Au,2000,,199228.21,Withdrawals & Transfers,ATM & EFTPOS
20/04/2023,Tfr Wdl BPAY Internet         20Apr08:39 4601843800646786    Banksa Cards,1000,,201228.21,Withdrawals & Transfers,Withdrawal
18/04/2023,Visa Purchase                 14Apr Sa Water             Adelaide,54.55,,202228.21,Bills & Payments,Utilities & Rates
18/04/2023,Visa Purchase                 14Apr Bakery On O'Connell  North Ade,22.7,,202282.76,Food & Beverage,Food & Groceries
17/04/2023,Visa Purchase                 13Apr Ezymart 118 K W S Pl Adelaide,8.98,,202305.46,Food & Beverage,Food & Groceries
17/04/2023,Property Managme Rent,,849.52,202314.44,Deposits,Deposit
17/04/2023,Loan Repayment S.514.2655406.00,4696,,201464.92,Home & Property,Mortgage & Rent
15/04/2023,Osko Withdrawal               15Apr20:36 Michelle,350,,206160.92,Withdrawals & Transfers,Withdrawal
14/04/2023,Raa 33512344_7_1,70.66,,206510.92,Transport & Travel,Vehicle Expenses
14/04/2023,Visa Purchase                 06Apr Cumberland Arms Hote Adelaide,9.5,,206581.58,Food & Beverage,Beverages
14/04/2023,Atm Withdrawal                14Apr12:38 Rundle Place Os          Adelaide     Au,1000,,206591.08,Withdrawals & Transfers,ATM & EFTPOS
13/04/2023,Osko Deposit                  13Apr18:03 Courtney Anne Girdler Sweet Image Hire,,200,207591.08,Deposits,Deposit
13/04/2023,Osko Deposit                  13Apr09:58 Mrs Michelle Ann Russell,,270,207391.08,Deposits,Deposit
13/04/2023,Tfr Wdl BPAY Internet         13Apr06:24 4601843800646786    Banksa Cards,1500,,207121.08,Withdrawals & Transfers,Withdrawal
12/04/2023,Visa Purchase                 10Apr Medibank Phi Debit   Melbourne,543.35,,208621.08,Bills & Payments,Insurance
12/04/2023,Raa 33512344_6_2,70.66,,209164.43,Transport & Travel,Vehicle Expenses
12/04/2023,Raa 33748936_5_2,33.75,,209235.09,Transport & Travel,Vehicle Expenses
12/04/2023,Raa 32276905_10_2,20.83,,209268.84,Transport & Travel,Vehicle Expenses
12/04/2023,Raa 33564303_6_2,16.58,,209289.67,Transport & Travel,Vehicle Expenses
11/04/2023,American Express 376012649071009,7431.69,,209306.25,Bills & Payments,Expenses & Payments
11/04/2023,Visa Purchase                 06Apr The Coffee Club Gepp Gepps Cro,58.9,,216737.94,Food & Beverage,Beverages
11/04/2023,Visa Purchase                 06Apr On The Way Convenien Adelaide,6.5,,216796.84,Food & Beverage,Food & Groceries
11/04/2023,Internet Deposit              11Apr13:56 From 9000204517840,,10000,216803.34,Deposits,Deposit
11/04/2023,Tfr Wdl BPAY Internet         11Apr10:08 4601843800646786    Banksa Cards,25,,206803.34,Withdrawals & Transfers,Withdrawal
8/04/2023,Visa Purchase                 04Apr Singh Thai Restauran Adelaide,24.5,,206828.34,Food & Beverage,Dining out
6/04/2023,Atm Withdrawal                06Apr12:46 Banksa                Adelaide Sa  5  Au,2000,,206852.84,Withdrawals & Transfers,ATM & EFTPOS
6/04/2023,Osko Withdrawal               06Apr08:50 Hayley,400,,208852.84,Withdrawals & Transfers,Withdrawal
5/04/2023,Osko Withdrawal               05Apr15:32 Hayley,300,,209252.84,Withdrawals & Transfers,Withdrawal
5/04/2023,Atm Withdrawal                05Apr10:29 Banksa                Adelaide Sa  5  Au,1200,,209552.84,Withdrawals & Transfers,ATM & EFTPOS
5/04/2023,Osko Deposit                  05Apr06:46 Mrs Michelle Ann Russell,,245,210752.84,Deposits,Deposit
5/04/2023,Atm Operator Fee Wdl          04Apr23:38 Atmx 139 Oconnell St   North Adelaid08Au,3,,210507.84,Fees & Charges,Fees & Charges
5/04/2023,Atm Withdrawal                04Apr23:38 Atmx 139 Oconnell St   North Adelaid08Au,2000,,210510.84,Withdrawals & Transfers,ATM & EFTPOS
4/04/2023,Visa Purchase                 31Mar Bakery On O'Connell  North Ade,15.9,,212510.84,Food & Beverage,Food & Groceries
4/04/2023,Visa Purchase                 01Apr Bakery On O'Connell  North Ade,15.9,,212526.74,Food & Beverage,Food & Groceries
1/04/2023,Visa Purchase                 30Mar 2Co.Com*Revouninstal Amsterdam,18.69,,212542.64,Home & Property,Technology & Appliances
1/04/2023,Visa Purchase                 29Mar Ezymart 118 K W S Pl Adelaide,4.99,,212561.33,Food & Beverage,Food & Groceries
31/03/2023,Visa Purchase                 30Mar Medibank Phi Debit   Melbourne,17.85,,212566.32,Bills & Payments,Insurance
31/03/2023,Property Managme Rent,,429.52,212584.17,Deposits,Deposit
30/03/2023,Visa Purchase                 27Mar Bakery On O'Connell  North Ade,34,,212154.65,Food & Beverage,Food & Groceries
30/03/2023,Visa Purchase                 27Mar Giuseppe Paradiso    Adelaide,5,,212188.65,Food & Beverage,Dining out
29/03/2023,Visa Purchase                 26Mar Bakery On O'Connell  North Ade,12,,212193.65,Food & Beverage,Food & Groceries
29/03/2023,Osko Deposit                  29Mar12:00 Mrs Michelle Ann Russell,,245,212205.65,Deposits,Deposit
28/03/2023,Visa Purchase                 25Mar Bakery On O'Connell  North Ade,12.2,,211960.65,Food & Beverage,Food & Groceries
28/03/2023,Atm Withdrawal                28Mar10:28 Rundle Place Os          Adelaide     Au,2000,,211972.85,Withdrawals & Transfers,ATM & EFTPOS
23/03/2023,Cardless Atm Withdrawal       23Mar13:58 Banksa                Adelaide Sa  5  Au,500,,213972.85,Withdrawals & Transfers,ATM & EFTPOS
22/03/2023,Cardless Atm Withdrawal       22Mar14:06 Rundle Place Os          Adelaide     Au,500,,214472.85,Withdrawals & Transfers,ATM & EFTPOS
22/03/2023,Osko Deposit                  22Mar07:22 Mrs Michelle Ann Russell,,225,214972.85,Deposits,Deposit
21/03/2023,Allianz Aust 1Rd221368017523080,129.35,,214747.85,Bills & Payments,Insurance
21/03/2023,Allianz Aust 1Rd220985017523080,19.44,,214877.2,Bills & Payments,Insurance
18/03/2023,Visa Purchase                 17Mar Medibank Phi Payment Melbourne,543.35,,214896.64,Bills & Payments,Insurance
16/03/2023,American Express 376012649071009,15980.98,,215439.99,Bills & Payments,Expenses & Payments
16/03/2023,Loan Repayment S.514.2655406.00,4696,,231420.97,Home & Property,Mortgage & Rent
16/03/2023,Atm Operator Fee Wdl          16Mar14:56 Atmx 139 Oconnell St   North Adelaid08Au,3,,236116.97,Fees & Charges,Fees & Charges
16/03/2023,Atm Withdrawal                16Mar14:56 Atmx 139 Oconnell St   North Adelaid08Au,2000,,236119.97,Withdrawals & Transfers,ATM & EFTPOS
16/03/2023,Cardless Atm Withdrawal       16Mar12:49 Banksa                Adelaide     5  Au,500,,238119.97,Withdrawals & Transfers,ATM & EFTPOS
15/03/2023,Property Managme Rent,,1144.52,238619.97,Deposits,Deposit
15/03/2023,Osko Deposit                  15Mar15:08 Mrs Michelle Ann Russell,,25,237475.45,Deposits,Deposit
10/03/2023,Osko Deposit                  10Mar13:04 Mrs Michelle Ann Russell,,60,237450.45,Deposits,Deposit
9/03/2023,Osko Deposit                  09Mar17:39 Mrs Michelle Ann Russell,,100,237390.45,Deposits,Deposit
8/03/2023,Visa Purchase                 05Mar The Jnrs Arms Htl Pl Hindmarsh,29,,237290.45,Food & Beverage,Beverages
8/03/2023,Visa Purchase                 06Mar Raa                  Mile End,20.83,,237319.45,Transport & Travel,Vehicle Expenses
8/03/2023,Visa Purchase                 05Mar The Jnrs Arms Htl Pl Hindmarsh,10,,237340.28,Food & Beverage,Beverages
8/03/2023,Visa Purchase                 05Mar Governor Hindmarsh H Hindmarsh,10,,237350.28,Food & Beverage,Beverages
8/03/2023,Osko Withdrawal               08Mar10:44 Hayley,700,,237360.28,Withdrawals & Transfers,Withdrawal
7/03/2023,Foreign Currency Conversn Fee,1.95,,238060.28,Fees & Charges,Fees & Charges
7/03/2023,Visa Purchase O/Seas          04Mar Usd43.58 Amzn Mktp Us*H51Py8O,65.11,,238062.23,Entertainment & Recreation,Books & Subscriptions
7/03/2023,Cash Withdrawal,1500,,238127.34,Withdrawals & Transfers,Withdrawal
7/03/2023,Cardless Atm Withdrawal       07Mar15:50 Banksa                Adelaide     5  Au,500,,239627.34,Withdrawals & Transfers,ATM & EFTPOS
6/03/2023,Visa Purchase                 02Mar Bakery On O'Connell  North Ade,24.4,,240127.34,Food & Beverage,Food & Groceries
3/03/2023,Visa Purchase                 28Feb Bakery On O'Connell  North Ade,11.3,,240151.74,Food & Beverage,Food & Groceries
2/03/2023,Visa Purchase                 28Feb Raa                  Mile End,33.75,,240163.04,Transport & Travel,Vehicle Expenses
2/03/2023,Visa Purchase                 27Feb Bakery On O'Connell  North Ade,23.7,,240196.79,Food & Beverage,Food & Groceries
2/03/2023,Visa Purchase                 28Feb Raa                  Mile End,16.58,,240220.49,Transport & Travel,Vehicle Expenses
1/03/2023,Visa Purchase                 26Feb North Adelaide Burge North Ade,20.5,,240237.07,Food & Beverage,Dining out
1/03/2023,Osko Deposit                  01Mar14:46 Me  Mrs Michelle Ann Russell,,200,240257.57,Deposits,Deposit
1/03/2023,Tfr Wdl BPAY Internet         01Mar06:00 111534              City Of Adelaide,614.9,,240057.57,Bills & Payments,Tax payments
1/03/2023,Tfr Wdl BPAY Internet         01Mar06:00 440057              City Of Adelaide,538.75,,240672.47,Bills & Payments,Tax payments
28/02/2023,Property Managme Rent,,1122.52,241211.22,Deposits,Deposit
27/02/2023,Visa Purchase                 24Feb North Adelaide Fitne East Hill,27.9,,240088.7,Retail & Personal,Health & Fitness
27/02/2023,Visa Purchase                 23Feb Bakery On O'Connell  North Ade,16.7,,240116.6,Food & Beverage,Food & Groceries
25/02/2023,Osko Withdrawal               25Feb19:05 Hayley,300,,240133.3,Withdrawals & Transfers,Withdrawal
25/02/2023,Osko Withdrawal               25Feb13:56 Michelle,100,,240433.3,Withdrawals & Transfers,Withdrawal
24/02/2023,Visa Purchase                 22Feb Optus Billing Autopa Macquarie,92.75,,240533.3,Bills & Payments,Telecommunications
22/02/2023,Visa Purchase                 20Feb Myrepublic           612831768,109,,240626.05,Bills & Payments,Telecommunications
22/02/2023,Visa Purchase                 19Feb Bakery On O'Connell  North Ade,29.6,,240735.05,Food & Beverage,Food & Groceries
22/02/2023,Visa Purchase                 20Feb City Bbq & Yum Cha P Sa Sa,16,,240764.65,Food & Beverage,Dining out
22/02/2023,Osko Deposit                  22Feb20:09 Mrs Michelle Ann Russell,,200,240780.65,Deposits,Deposit
21/02/2023,Allianz Aust 1Rd221368014423052,129.35,,240580.65,Bills & Payments,Insurance
21/02/2023,Allianz Aust 1Rd220985014423052,19.44,,240710,Bills & Payments,Insurance
21/02/2023,Visa Purchase                 17Feb Bakery On O'Connell  North Ade,17.4,,240729.44,Food & Beverage,Food & Groceries
21/02/2023,Atm Operator Fee Wdl          21Feb15:13 Atmx 139 Oconnell St   North Adelaid08Au,3,,240746.84,Fees & Charges,Fees & Charges
21/02/2023,Atm Withdrawal                21Feb15:13 Atmx 139 Oconnell St   North Adelaid08Au,2000,,240749.84,Withdrawals & Transfers,ATM & EFTPOS
20/02/2023,Foreign Currency Conversn Fee,1.31,,242749.84,Fees & Charges,Fees & Charges
20/02/2023,Visa Purchase O/Seas          17Feb Usd29.95 Lucky Rabbit Technol,43.8,,242751.15,Home & Property,Technology & Appliances
20/02/2023,Visa Purchase                 17Feb Pasta Go Go North Ad North Ade,14.4,,242794.95,Food & Beverage,Dining out
20/02/2023,Atm Withdrawal                20Feb11:10 Rundle Place Os          Adelaide     Au,2000,,242809.35,Withdrawals & Transfers,ATM & EFTPOS
20/02/2023,Atm Operator Fee Wdl          19Feb18:44 Atmx 139 Oconnell St   North Adelaid08Au,3,,244809.35,Fees & Charges,Fees & Charges
20/02/2023,Atm Withdrawal                19Feb18:44 Atmx 139 Oconnell St   North Adelaid08Au,800,,244812.35,Withdrawals & Transfers,ATM & EFTPOS
18/02/2023,Visa Credit                   15Feb Transportfornsw Tap  Sydney,,1.52,245612.35,Deposits,Deposit
18/02/2023,Visa Purchase                 16Feb City Bbq & Yum Cha P Sa Sa,19.5,,245610.83,Food & Beverage,Dining out
18/02/2023,Osko Deposit                  18Feb16:30 Thank U Xx Kellie Bond,,300,245630.33,Deposits,Deposit
17/02/2023,Visa Purchase                 14Feb Bakery On O'Connell  North Ade,29.6,,245330.33,Food & Beverage,Food & Groceries
17/02/2023,Visa Purchase                 13Feb Delaware North Retai Redcliffe,13,,245359.93,Food & Beverage,Dining out
17/02/2023,Internet Withdrawal           17Feb10:39 To 105-131 491577540,700,,245372.93,Withdrawals & Transfers,Funds transfer
16/02/2023,Visa Purchase                 14Feb Raa                  Mile End,70.66,,246072.93,Transport & Travel,Vehicle Expenses
16/02/2023,Loan Repayment S.514.2655406.00,4582,,246143.59,Home & Property,Mortgage & Rent
16/02/2023,Osko Withdrawal               16Feb09:30 144275 Fopr Order 144275 Ozsmoke,182.2,,250725.59,Withdrawals & Transfers,Withdrawal
16/02/2023,Osko Deposit                  16Feb07:47 Mrs Michelle Ann Russell,,140,250907.79,Deposits,Deposit
15/02/2023,Visa Purchase                 10Feb Ct Storeco Pty Ltd   Midvale,32.98,,250767.79,Food & Beverage,Dining out
15/02/2023,Property Managme Rent,,1144.52,250800.77,Deposits,Deposit
15/02/2023,Atm Operator Fee Wdl          15Feb14:11 Atmx 139 Oconnell St   North Adelaid08Au,3,,249656.25,Fees & Charges,Fees & Charges
15/02/2023,Atm Withdrawal                15Feb14:11 Atmx 139 Oconnell St   North Adelaid08Au,700,,249659.25,Withdrawals & Transfers,ATM & EFTPOS
15/02/2023,Osko Withdrawal               14Feb22:51 Kelli,20,,250359.25,Withdrawals & Transfers,Withdrawal
14/02/2023,American Express 376012649071009,5108.18,,250379.25,Bills & Payments,Expenses & Payments
14/02/2023,Atm Operator Fee Wdl          14Feb17:03 Atmx 139 Oconnell St   North Adelaid08Au,3,,255487.43,Fees & Charges,Fees & Charges
14/02/2023,Atm Withdrawal                14Feb17:03 Atmx 139 Oconnell St   North Adelaid08Au,450,,255490.43,Withdrawals & Transfers,ATM & EFTPOS
14/02/2023,Atm Operator Fee Wdl          14Feb09:54 Atmx 139 Oconnell St   North Adelaid08Au,3,,255940.43,Fees & Charges,Fees & Charges
14/02/2023,Atm Withdrawal                14Feb09:54 Atmx 139 Oconnell St   North Adelaid08Au,1200,,255943.43,Withdrawals & Transfers,ATM & EFTPOS
14/02/2023,Osko Withdrawal               14Feb06:55 K Bond,850,,257143.43,Withdrawals & Transfers,Withdrawal
13/02/2023,Visa Purchase                 10Feb North Adelaide Fitne East Hill,27.9,,257993.43,Retail & Personal,Health & Fitness
13/02/2023,Visa Purchase                 09Feb Bakery On O'Connell  North Ade,18.2,,258021.33,Food & Beverage,Food & Groceries
11/02/2023,Visa Purchase                 09Feb Myrepublic           612831768,107,,258039.53,Bills & Payments,Telecommunications
10/02/2023,Visa Purchase                 09Feb Medibank Phi Debit   Melbourne,543.35,,258146.53,Bills & Payments,Insurance
10/02/2023,Visa Purchase                 07Feb Bakery On O'Connell  North Ade,11.9,,258689.88,Food & Beverage,Food & Groceries
9/02/2023,Visa Purchase                 07Feb Krung Thep           North Ade,32,,258701.78,Food & Beverage,Dining out
9/02/2023,Osko Deposit                  09Feb10:34 Mrs Michelle Ann Russell,,225,258733.78,Deposits,Deposit
9/02/2023,Atm Operator Fee Wdl          09Feb09:58 Atmx 139 Oconnell St   North Adelaid08Au,3,,258508.78,Fees & Charges,Fees & Charges
9/02/2023,Atm Withdrawal                09Feb09:58 Atmx 139 Oconnell St   North Adelaid08Au,800,,258511.78,Withdrawals & Transfers,ATM & EFTPOS
8/02/2023,Visa Purchase                 06Feb Crikey               613862399,199,,259311.78,Entertainment & Recreation,Books & Subscriptions
8/02/2023,Visa Purchase                 06Feb Raa                  Mile End,20.83,,259510.78,Transport & Travel,Vehicle Expenses
7/02/2023,Visa Purchase                 04Feb Bakery On O'Connell  North Ade,23.2,,259531.61,Food & Beverage,Food & Groceries
7/02/2023,Visa Purchase                 03Feb Blue And White Cafe  North Ade,13,,259554.81,Food & Beverage,Dining out
6/02/2023,Visa Purchase                 02Feb The Coffee Club Gepp Gepps Cro,43.4,,259567.81,Food & Beverage,Beverages
4/02/2023,Visa Purchase                 01Feb Bakery On O'Connell  North Ade,17.7,,259611.21,Food & Beverage,Food & Groceries
3/02/2023,Visa Purchase                 01Feb Adelaide Health Care Adelaide,82.4,,259628.91,Retail & Personal,Medical & Personal care
3/02/2023,Visa Purchase                 01Feb Dumpling 100 Express Adelaide,12.8,,259711.31,Food & Beverage,Dining out
3/02/2023,Atm Withdrawal                03Feb12:23 Banksa                Adelaide Sa  5  Au,1500,,259724.11,Withdrawals & Transfers,ATM & EFTPOS
3/02/2023,Osko Deposit                  03Feb07:50 Courtney A Girdler,,350,261224.11,Deposits,Deposit
2/02/2023,Visa Purchase                 30Jan Johns Men Hair Styli Waterloo,40,,260874.11,Retail & Personal,Retail (shopping)
1/02/2023,Visa Purchase                 27Jan Vine Providore       Redfern,115.8,,260914.11,Food & Beverage,Beverages
1/02/2023,Visa Purchase                 30Jan Raa                  Mile End,33.75,,261029.91,Transport & Travel,Vehicle Expenses
1/02/2023,Visa Purchase                 30Jan Raa                  Mile End,16.58,,261063.66,Transport & Travel,Vehicle Expenses
1/02/2023,Visa Purchase                 27Jan Moz Food Service Pty Waterloo,15.45,,261080.24,Food & Beverage,Dining out
1/02/2023,Osko Deposit                  01Feb16:37 Mrs Michelle Ann Russell,,225,261095.69,Deposits,Deposit
1/02/2023,Atm Withdrawal                01Feb14:17 Banksa                Adelaide Sa  5  Au,1000,,260870.69,Withdrawals & Transfers,ATM & EFTPOS
1/02/2023,Osko Deposit                  01Feb12:07 Michelle  Mrs Michelle Ann Russell,,150,261870.69,Deposits,Deposit
1/02/2023,Osko Withdrawal               01Feb09:49 Hayley,200,,261720.69,Withdrawals & Transfers,Withdrawal
31/01/2023,Visa Purchase                 26Jan Delaware North Retai Adelaide,17,,261920.69,Transport & Travel,Hotels and Accommodation
31/01/2023,Visa Purchase                 27Jan Transportfornsw Tap  Sydney,5.05,,261937.69,Transport & Travel,Public transport
31/01/2023,Property Managme Rent,,1144.52,261942.74,Deposits,Deposit
30/01/2023,Visa Purchase                 26Jan Gm Cabs Pty Ltd      Mascot,50.4,,260798.22,Transport & Travel,Taxi & Rental car
30/01/2023,Visa Purchase                 27Jan North Adelaide Fitne East Hill,27.9,,260848.62,Retail & Personal,Health & Fitness
28/01/2023,Visa Purchase                 26Jan Coles 0987           Waterloo,18,,260876.52,Food & Beverage,Food & Groceries
28/01/2023,Visa Purchase                 25Jan Bakery On O'Connell  North Ade,17.7,,260894.52,Food & Beverage,Food & Groceries
28/01/2023,Visa Purchase                 26Jan Whsadelaideairsides4 Adelaide,12.04,,260912.22,Entertainment & Recreation,Books & Subscriptions
28/01/2023,Visa Purchase                 24Jan Bakery On O'Connell  North Ade,11.3,,260924.26,Food & Beverage,Food & Groceries
28/01/2023,Osko Withdrawal               28Jan12:39 Michelle,150,,260935.56,Withdrawals & Transfers,Withdrawal
27/01/2023,Visa Purchase                 22Jan Foodworks North Adel North Ade,38.45,,261085.56,Food & Beverage,Food & Groceries
27/01/2023,Visa Purchase                 23Jan Tcdr Pty Ltd         North Ade,3.95,,261124.01,Entertainment & Recreation,Books & Subscriptions
27/01/2023,Atm Operator Fee Wdl          26Jan11:46 Atmx 139 Oconnell St   North Adelaid08Au,3,,261127.96,Fees & Charges,Fees & Charges
27/01/2023,Atm Withdrawal                26Jan11:46 Atmx 139 Oconnell St   North Adelaid08Au,350,,261130.96,Withdrawals & Transfers,ATM & EFTPOS
25/01/2023,Visa Purchase                 23Jan V/Cellars 3327       N Adelaid,103,,261480.96,Food & Beverage,Beverages
25/01/2023,Visa Purchase                 23Jan Nth Adel Foodland    North Ade,72.55,,261583.96,Food & Beverage,Food & Groceries
25/01/2023,Visa Purchase                 21Jan Caledonian Hotel Nor North Ade,50.5,,261656.51,Food & Beverage,Dining out
25/01/2023,Visa Purchase                 23Jan Jeff Ramsey Pharmaci North Ade,34.96,,261707.01,Retail & Personal,Medical & Personal care
25/01/2023,Visa Purchase                 23Jan Gt & Hg Pty Ltd      North Ade,24.73,,261741.97,Food & Beverage,Food & Groceries
25/01/2023,Visa Purchase                 21Jan Caledonian Hotel Nor North Ade,18.69,,261766.7,Food & Beverage,Dining out
25/01/2023,Visa Purchase                 23Jan Shijia Service Pty L Adelaide,14.3,,261785.39,Food & Beverage,Food & Groceries
25/01/2023,Atm Operator Fee Wdl          25Jan07:18 Atmx 139 Oconnell St   North Adelaid08Au,3,,261799.69,Fees & Charges,Fees & Charges
25/01/2023,Atm Withdrawal                25Jan07:18 Atmx 139 Oconnell St   North Adelaid08Au,700,,261802.69,Withdrawals & Transfers,ATM & EFTPOS
24/01/2023,Visa Purchase                 22Jan Optus Billing Autopa Macquarie,92.75,,262502.69,Bills & Payments,Telecommunications
24/01/2023,Visa Purchase                 20Jan Bunnings 356000      Mile End,63.32,,262595.44,Home & Property,Maintenance
24/01/2023,Visa Purchase                 20Jan Sq *Village Asian Gr North Ade,34.15,,262658.76,Food & Beverage,Food & Groceries
24/01/2023,Visa Purchase                 20Jan Bakery On O'Connell  North Ade,11,,262692.91,Food & Beverage,Food & Groceries
24/01/2023,Visa Purchase                 20Jan Southern And Western Glandore,3.5,,262703.91,Entertainment & Recreation,TV
24/01/2023,Osko Deposit                  24Jan19:07 Michelle  Mrs Michelle Ann Russell,,150,262707.41,Deposits,Deposit
24/01/2023,Osko Withdrawal               24Jan16:01 4044 Payment For Invoice 404 Cosywrap,750,,262557.41,Withdrawals & Transfers,Withdrawal
24/01/2023,Osko Withdrawal               24Jan16:00 4043 Payment For Invoice 404 Cosywrap,3038,,263307.41,Withdrawals & Transfers,Withdrawal
23/01/2023,Allianz Aust 1Rd221368011323023,129.35,,266345.41,Bills & Payments,Insurance
23/01/2023,Visa Purchase                 20Jan V/Cellars 3327       N Adelaid,111,,266474.76,Food & Beverage,Beverages
23/01/2023,Visa Purchase                 20Jan Myrepublic           612831768,102.55,,266585.76,Bills & Payments,Telecommunications
23/01/2023,Allianz Aust 1Rd220985011323023,19.44,,266688.31,Bills & Payments,Insurance
23/01/2023,Visa Purchase                 19Jan Bakery On O'Connell  North Ade,17.7,,266707.75,Food & Beverage,Food & Groceries
23/01/2023,Visa Purchase                 20Jan Nth Adel Foodland    North Ade,14.23,,266725.45,Food & Beverage,Food & Groceries
23/01/2023,Visa Purchase                 20Jan Alh Venues/123 Oconn Nrth Adel,8.9,,266739.68,Transport & Travel,Hotels and Accommodation
23/01/2023,Internet Withdrawal           23Jan17:34 To 9000204517840,1000,,266748.58,Withdrawals & Transfers,Funds transfer
23/01/2023,Atm Withdrawal                23Jan07:45 Rundle Place Os          Adelaide     Au,1500,,267748.58,Withdrawals & Transfers,ATM & EFTPOS
21/01/2023,Visa Purchase                 19Jan Jaycar Electronics   Adelaide,19.95,,269248.58,Home & Property,Technology & Appliances
21/01/2023,Osko Withdrawal               21Jan12:28 Michelle,150,,269268.53,Withdrawals & Transfers,Withdrawal
20/01/2023,Visa Purchase                 17Jan Dit - Ezyreg         Adelaide,392.8,,269418.53,Transport & Travel,Vehicle Expenses
20/01/2023,Visa Purchase                 18Jan Adelaide Health Care Adelaide,122,,269811.33,Retail & Personal,Medical & Personal care
20/01/2023,Visa Purchase                 18Jan Funk Coffee And Food Adelaide,6,,269933.33,Food & Beverage,Beverages
20/01/2023,Osko Withdrawal               20Jan12:23 Pre Pay Hayley,500,,269939.33,Withdrawals & Transfers,Withdrawal
19/01/2023,Visa Purchase                 17Jan V/Cellars 3327       N Adelaid,140,,270439.33,Food & Beverage,Beverages
19/01/2023,Visa Purchase                 16Jan Sq *Wrenglade Counse Adelaide,110,,270579.33,Retail & Personal,Medical & Personal care
19/01/2023,Visa Purchase                 17Jan Nth Adel Foodland    North Ade,67.29,,270689.33,Food & Beverage,Food & Groceries
19/01/2023,Visa Purchase                 16Jan Bakery On O'Connell  North Ade,17.6,,270756.62,Food & Beverage,Food & Groceries
19/01/2023,Visa Purchase                 16Jan North Adelaide Burge North Ade,15.5,,270774.22,Food & Beverage,Dining out
18/01/2023,Visa Purchase                 16Jan Raa                  Mile End,70.66,,270789.72,Transport & Travel,Vehicle Expenses
18/01/2023,Eftpos Debit                  18Jan06:38 Beem It\,100,,270860.38,Withdrawals & Transfers,Funds transfer
17/01/2023,Visa Purchase                 13Jan Foodworks North Adel North Ade,44.51,,270960.38,Food & Beverage,Food & Groceries
17/01/2023,Visa Purchase                 15Jan Bakery On O'Connell  North Ade,28.1,,271004.89,Food & Beverage,Food & Groceries
17/01/2023,Visa Purchase                 13Jan Bakery On O'Connell  North Ade,17.7,,271032.99,Food & Beverage,Food & Groceries
16/01/2023,Visa Purchase                 12Jan Dit - Ezyreg         Adelaide,682.64,,271050.69,Transport & Travel,Vehicle Expenses
16/01/2023,Visa Purchase                 12Jan Sa Water             Adelaide,473.55,,271733.33,Bills & Payments,Utilities & Rates
16/01/2023,Visa Purchase                 13Jan Bws/123 Oconnell Str Nrth Adel,61,,272206.88,Food & Beverage,Beverages
16/01/2023,Visa Purchase                 13Jan North Adelaide Fitne East Hill,27.9,,272267.88,Retail & Personal,Health & Fitness
16/01/2023,Property Managme Rent,,1144.52,272295.78,Deposits,Deposit
16/01/2023,Loan Repayment S.514.2655406.00,4462,,271151.26,Home & Property,Mortgage & Rent
14/01/2023,Foreign Currency Conversn Fee,2.87,,275613.26,Fees & Charges,Fees & Charges
14/01/2023,Visa Purchase O/Seas          13Jan Usd65.84 1Password,95.8,,275616.13,Home & Property,Technology & Appliances
14/01/2023,Visa Purchase                 12Jan Sq *Village Asian Gr North Ade,33.15,,275711.93,Food & Beverage,Food & Groceries
14/01/2023,Visa Purchase                 12Jan V/Cellars 3327       N Adelaid,22,,275745.08,Food & Beverage,Beverages
14/01/2023,Visa Purchase                 12Jan Jeff Ramsey Pharmacy North Ade,18.93,,275767.08,Retail & Personal,Medical & Personal care
13/01/2023,American Express 376012649071009,3530.47,,275786.01,Bills & Payments,Expenses & Payments
13/01/2023,Visa Purchase                 11Jan Adelaide Health Care Adelaide,94,,279316.48,Retail & Personal,Medical & Personal care
13/01/2023,Visa Purchase                 11Jan Jaycar Electronics   Adelaide,54.9,,279410.48,Home & Property,Technology & Appliances
13/01/2023,Visa Purchase                 09Jan Foodworks North Adel North Ade,17.7,,279465.38,Food & Beverage,Food & Groceries
13/01/2023,Visa Purchase                 11Jan City Bbq & Yum Cha P Sa Sa,16,,279483.08,Food & Beverage,Dining out
13/01/2023,Visa Purchase                 10Jan Bakery On O'Connell  North Ade,11.8,,279499.08,Food & Beverage,Food & Groceries
13/01/2023,Visa Purchase                 11Jan Shijia Service Pty L Adelaide,9.8,,279510.88,Food & Beverage,Food & Groceries
13/01/2023,Osko Withdrawal               13Jan12:20 Al,50,,279520.68,Withdrawals & Transfers,Withdrawal
12/01/2023,Visa Purchase                 10Jan Bws/123 Oconnell Str Nrth Adel,61,,279570.68,Food & Beverage,Beverages
12/01/2023,Osko Deposit                  12Jan15:04 Mrs Michelle Ann Russell,,250,279631.68,Deposits,Deposit
12/01/2023,Internet Deposit              12Jan08:30 From 0280074830940,,140000,279381.68,Deposits,Deposit
11/01/2023,Visa Purchase                 08Jan Myrepublic           612831768,107,,139381.68,Bills & Payments,Telecommunications
11/01/2023,Visa Purchase                 07Jan Foodworks North Adel North Ade,6.2,,139488.68,Food & Beverage,Food & Groceries
11/01/2023,Visa Purchase                 07Jan Caltex North Adelaid North Ade,5,,139494.88,Transport & Travel,Petrol
11/01/2023,Osko Withdrawal               11Jan14:02 From Andrew For Saturda C Bonnes,50,,139499.88,Withdrawals & Transfers,Withdrawal
11/01/2023,Atm Withdrawal                11Jan12:34 Banksa                Adelaide     5  Au,2000,,139549.88,Withdrawals & Transfers,ATM & EFTPOS
10/01/2023,Visa Purchase                 09Jan Medibank Phi Debit   Melbourne,521,,141549.88,Bills & Payments,Insurance
10/01/2023,Visa Purchase                 05Jan Sp Ozsmartthings     Sydney,203.95,,142070.88,Home & Property,Technology & Appliances
10/01/2023,Visa Purchase                 07Jan Warradale Hotel P/L  Warradale,110,,142274.83,Food & Beverage,Dining out
10/01/2023,Visa Purchase                 08Jan Bws/123 Oconnell Str Nrth Adel,61,,142384.83,Food & Beverage,Beverages
10/01/2023,Visa Purchase                 06Jan Foodworks North Adel North Ade,59.6,,142445.83,Food & Beverage,Food & Groceries
10/01/2023,Visa Purchase                 04Jan Dumpling City Sa Pty Adelaide,39.4,,142505.43,Food & Beverage,Dining out
10/01/2023,Visa Purchase                 06Jan Caltex North Adelaid North Ade,29,,142544.83,Transport & Travel,Petrol
10/01/2023,Visa Purchase                 08Jan Pasta Go Go North Ad North Ade,12.9,,142573.83,Food & Beverage,Dining out
10/01/2023,Visa Purchase                 06Jan Caltex North Adelaid North Ade,10,,142586.73,Transport & Travel,Petrol
10/01/2023,Visa Purchase                 07Jan Warradale Hotel P/L  Warradale,8.5,,142596.73,Food & Beverage,Dining out
10/01/2023,Atm Operator Fee Wdl          10Jan13:38 Royal Oak Nth Adl     Nrth Adelaid    Au,2.9,,142605.23,Fees & Charges,Fees & Charges
10/01/2023,Atm Withdrawal                10Jan13:38 Royal Oak Nth Adl     Nrth Adelaid    Au,250,,142608.13,Withdrawals & Transfers,ATM & EFTPOS
9/01/2023,Visa Purchase                 05Jan Sa Water             Adelaide,473.55,,142858.13,Bills & Payments,Utilities & Rates
9/01/2023,Visa Purchase                 06Jan Sq *Wrenglade Counse Adelaide,110,,143331.68,Retail & Personal,Medical & Personal care
9/01/2023,Visa Purchase                 06Jan V/Cellars 3327       N Adelaid,40,,143441.68,Food & Beverage,Beverages
9/01/2023,Visa Purchase                 04Jan Foodworks North Adel North Ade,36.81,,143481.68,Food & Beverage,Food & Groceries
9/01/2023,Visa Purchase                 06Jan Raa                  Mile End,20.83,,143518.49,Transport & Travel,Vehicle Expenses
9/01/2023,Visa Purchase                 06Jan Bakery On O'Connell  North Ade,16.5,,143539.32,Food & Beverage,Food & Groceries
9/01/2023,Visa Purchase                 06Jan Funk Coffee And Food Adelaide,6,,143555.82,Food & Beverage,Beverages
6/01/2023,Visa Purchase                 04Jan Adelaide Health Care Adelaide,86.35,,143561.82,Retail & Personal,Medical & Personal care
6/01/2023,Visa Purchase                 02Jan Caltex North Adelaid North Ade,33,,143648.17,Transport & Travel,Petrol
6/01/2023,Visa Purchase                 02Jan Foodworks North Adel North Ade,28.19,,143681.17,Food & Beverage,Food & Groceries
6/01/2023,Visa Purchase                 04Jan Bws/123 Oconnell Str Nrth Adel,25,,143709.36,Food & Beverage,Beverages
6/01/2023,Visa Purchase                 03Jan Mcdonalds Salb Plain Salisbury,21.3,,143734.36,Food & Beverage,Dining out
6/01/2023,Visa Purchase                 03Jan Zyan Petroleum Pty L Pooraka,15.55,,143755.66,Transport & Travel,Petrol
6/01/2023,Visa Purchase                 02Jan Airport Retail Enter Mascot,13.8,,143771.21,Food & Beverage,Dining out
6/01/2023,Visa Purchase                 04Jan Post North Adelaide  North Ade,11.99,,143785.01,Bills & Payments,Professional & Govt services
6/01/2023,Osko Deposit                  06Jan07:21 Mrs Michelle Ann Russell,,250,143797,Deposits,Deposit
4/01/2023,Visa Purchase                 31Dec V/Cellars 3185       Waterloo,60,,143547,Food & Beverage,Beverages
4/01/2023,Visa Purchase                 02Jan Bws/123 Oconnell Str Nrth Adel,49,,143607,Food & Beverage,Beverages
4/01/2023,Visa Purchase                 31Dec Coles 0987           Waterloo,17.9,,143656,Food & Beverage,Food & Groceries
4/01/2023,Mcare Benefits 473090744 Gywq,,39.75,143673.9,Government payments,Centrelink payments
3/01/2023,Visa Purchase                 29Dec Vine Providore       Redfern,72.55,,143634.15,Food & Beverage,Beverages
3/01/2023,Visa Purchase                 30Dec Coles 0987           Waterloo,52.85,,143706.7,Food & Beverage,Food & Groceries
3/01/2023,Visa Purchase                 30Dec V/Cellars 3185       Waterloo,49,,143759.55,Food & Beverage,Beverages
3/01/2023,Visa Purchase                 30Dec North Adelaide Fitne East Hill,27.9,,143808.55,Retail & Personal,Health & Fitness
3/01/2023,Osko Withdrawal               03Jan13:57 K Bond,150,,143836.45,Withdrawals & Transfers,Withdrawal
3/01/2023,Osko Withdrawal               02Jan12:57 Michelle,50,,143986.45,Withdrawals & Transfers,Withdrawal
3/01/2023,Atm Operator Fee Wdl          02Jan11:33 Atmx 139 Oconnell St   North Adelaid08Au,3,,144036.45,Fees & Charges,Fees & Charges
3/01/2023,Atm Withdrawal                02Jan11:33 Atmx 139 Oconnell St   North Adelaid08Au,2000,,144039.45,Withdrawals & Transfers,ATM & EFTPOS
3/01/2023,Osko Withdrawal               01Jan15:10 Al,4000,,146039.45,Withdrawals & Transfers,Withdrawal
31/12/2022,Visa Purchase                 28Dec Sp Vfm Group         Northgate,167.85,,150039.45,Home & Property,Services & Tradespeople
31/12/2022,Visa Purchase                 29Dec Raa                  Mile End,33.75,,150207.3,Transport & Travel,Vehicle Expenses
31/12/2022,Visa Purchase                 29Dec Raa                  Mile End,16.58,,150241.05,Transport & Travel,Vehicle Expenses
30/12/2022,Visa Purchase                 28Dec Bank Hotel           Newtown,18.5,,150257.63,Food & Beverage,Beverages
30/12/2022,Property Managme Rent,,1144.52,150276.13,Deposits,Deposit
29/12/2022,Visa Purchase                 24Dec Coles 0987           Waterloo,41.25,,149131.61,Food & Beverage,Food & Groceries
29/12/2022,Visa Purchase                 25Dec Transportfornsw Opal Chippenda,40,,149172.86,Transport & Travel,Public transport
29/12/2022,Visa Purchase                 26Dec Imperial Hotel Paddo Paddingto,20.16,,149212.86,Food & Beverage,Beverages
29/12/2022,Visa Purchase                 24Dec Yummy Thai Street Fo Sydney,18.17,,149233.02,Food & Beverage,Dining out
29/12/2022,Visa Purchase                 23Dec Delaware North Retai Adelaide,17,,149251.19,Transport & Travel,Hotels and Accommodation
29/12/2022,Visa Purchase                 23Dec Delaware North Retai Adelaide,17,,149268.19,Transport & Travel,Hotels and Accommodation
29/12/2022,Visa Purchase                 26Dec Coles 0987           Waterloo,8.25,,149285.19,Food & Beverage,Food & Groceries
29/12/2022,Visa Purchase                 25Dec Transportfornsw Tap  Sydney,3.53,,149293.44,Transport & Travel,Public transport
29/12/2022,Visa Purchase                 26Dec Transportfornsw Tap  Sydney,3.53,,149296.97,Transport & Travel,Public transport
28/12/2022,Visa Purchase                 23Dec Gm Cabs Pty Ltd      Mascot,36.23,,149300.5,Transport & Travel,Taxi & Rental car
28/12/2022,Visa Purchase                 21Dec Foodworks North Adel North Ade,35.57,,149336.73,Food & Beverage,Food & Groceries
28/12/2022,Visa Purchase                 23Dec Bar Cleveland        Redfern,9.09,,149372.3,Food & Beverage,Beverages
28/12/2022,Osko Withdrawal               28Dec14:31 Coffee Al,1100,,149381.39,Withdrawals & Transfers,Withdrawal
28/12/2022,Eftpos Debit                  27Dec06:23 Beem It\,50,,150481.39,Withdrawals & Transfers,Funds transfer
28/12/2022,Osko Withdrawal               27Dec12:12 Al,100,,150531.39,Withdrawals & Transfers,Withdrawal
24/12/2022,Visa Purchase                 22Dec Optus Billing Autopa Macquarie,94.25,,150631.39,Bills & Payments,Telecommunications
24/12/2022,Visa Purchase                 22Dec Alh Venues/123 Oconn Nrth Adel,44,,150725.64,Transport & Travel,Hotels and Accommodation
24/12/2022,Visa Purchase                 21Dec Bakery On O'Connell  North Ade,11.3,,150769.64,Food & Beverage,Food & Groceries
23/12/2022,Visa Purchase                 20Dec Smp*Stirling Chicken Stirling,70.14,,150780.94,Food & Beverage,Dining out
23/12/2022,Visa Purchase                 19Dec Foodworks North Adel North Ade,41.39,,150851.08,Food & Beverage,Food & Groceries
23/12/2022,Visa Purchase                 21Dec Jaycar Electronics   Adelaide,35.7,,150892.47,Home & Property,Technology & Appliances
23/12/2022,Visa Purchase                 21Dec Bws/123 Oconnell Str Nrth Adel,25,,150928.17,Food & Beverage,Beverages
23/12/2022,Visa Purchase                 20Dec Stirling Day Night P Stirling,20.99,,150953.17,Retail & Personal,Medical & Personal care
22/12/2022,Visa Purchase                 20Dec Myrepublic           612831768,99,,150974.16,Bills & Payments,Telecommunications
22/12/2022,Visa Purchase                 19Dec Bakery On O'Connell  North Ade,17.6,,151073.16,Food & Beverage,Food & Groceries
22/12/2022,Osko Withdrawal               22Dec03:54 House Sitting Al,1100,,151090.76,Withdrawals & Transfers,Withdrawal
21/12/2022,Allianz Aust 1Rd221368017322355,129.35,,152190.76,Bills & Payments,Insurance
21/12/2022,Visa Purchase                 18Dec Bakery On O'Connell  North Ade,34.1,,152320.11,Food & Beverage,Food & Groceries
21/12/2022,Allianz Aust 1Rd220985017322355,19.44,,152354.21,Bills & Payments,Insurance
21/12/2022,Osko Deposit                  21Dec20:10 M  Mrs Michelle Ann Russell,,30,152373.65,Deposits,Deposit
20/12/2022,Visa Purchase                 17Dec Bws/123 Oconnell Str Nrth Adel,98,,152343.65,Food & Beverage,Beverages
20/12/2022,Visa Purchase                 16Dec Governor Hindmarsh H Hindmarsh,25.5,,152441.65,Food & Beverage,Beverages
20/12/2022,Visa Purchase                 17Dec Bakery On O'Connell  North Ade,23.8,,152467.15,Food & Beverage,Food & Groceries
20/12/2022,Visa Purchase                 16Dec Bakery On O'Connell  North Ade,17.5,,152490.95,Food & Beverage,Food & Groceries
20/12/2022,Visa Purchase                 16Dec Governor Hindmarsh H Hindmarsh,10,,152508.45,Food & Beverage,Beverages
20/12/2022,Visa Purchase                 16Dec Governor Hindmarsh H Hindmarsh,10,,152518.45,Food & Beverage,Beverages
19/12/2022,Visa Purchase                 16Dec Benson Radiology     North Ade,525.4,,152528.45,Retail & Personal,Medical & Personal care
19/12/2022,Visa Purchase                 14Dec Foodworks North Adel North Ade,61.52,,153053.85,Food & Beverage,Food & Groceries
19/12/2022,Visa Purchase                 16Dec North Adelaide Fitne East Hill,27.9,,153115.37,Retail & Personal,Health & Fitness
19/12/2022,Visa Purchase                 16Dec Jeff Ramsey Pharmacy North Ade,22,,153143.27,Retail & Personal,Medical & Personal care
19/12/2022,Visa Purchase                 15Dec Tcdr Pty Ltd         North Ade,14.95,,153165.27,Entertainment & Recreation,Books & Subscriptions
19/12/2022,Visa Purchase                 16Dec St Georges Bakehouse Croydon,10.4,,153180.22,Food & Beverage,Dining out
19/12/2022,Atm Operator Fee Wdl          19Dec07:57 Atmx 139 Oconnell St   North Adelaid08Au,3,,153190.62,Fees & Charges,Fees & Charges
19/12/2022,Atm Withdrawal                19Dec07:57 Atmx 139 Oconnell St   North Adelaid08Au,700,,153193.62,Withdrawals & Transfers,ATM & EFTPOS
17/12/2022,Visa Purchase                 15Dec Nth Adel Foodland    North Ade,86.47,,153893.62,Food & Beverage,Food & Groceries
17/12/2022,Visa Purchase                 15Dec Sp Vfm Group         Northgate,66.15,,153980.09,Home & Property,Services & Tradespeople
17/12/2022,Visa Purchase                 15Dec V/Cellars 3327       N Adelaid,44,,154046.24,Food & Beverage,Beverages
17/12/2022,Visa Purchase                 14Dec Bakery On O'Connell  North Ade,17.2,,154090.24,Food & Beverage,Food & Groceries
17/12/2022,Visa Purchase                 15Dec Gt & Hg Pty Ltd      North Ade,16.83,,154107.44,Food & Beverage,Food & Groceries
17/12/2022,Osko Withdrawal               16Dec23:16 As Discussed Al,1100,,154124.27,Withdrawals & Transfers,Withdrawal
16/12/2022,Visa Purchase                 14Dec Raa                  Mile End,70.66,,155224.27,Transport & Travel,Vehicle Expenses
16/12/2022,Visa Purchase                 14Dec Bws/123 Oconnell Str Nrth Adel,25,,155294.93,Food & Beverage,Beverages
16/12/2022,Visa Purchase                 12Dec Foodworks North Adel North Ade,23.83,,155319.93,Food & Beverage,Food & Groceries
16/12/2022,Visa Purchase                 13Dec All Day Stores Pty L Adelaide,10,,155343.76,Food & Beverage,Food & Groceries
16/12/2022,Visa Purchase                 12Dec Caltex North Adelaid North Ade,5.5,,155353.76,Transport & Travel,Petrol
16/12/2022,Property Managme Rent,,1144.52,155359.26,Deposits,Deposit
16/12/2022,Mcare Benefits 463131009 Eywq,,175.4,154214.74,Government payments,Centrelink payments
16/12/2022,Osko Deposit                  16Dec20:25 Mrs Michelle Ann Russell,,65,154039.34,Deposits,Deposit
16/12/2022,Osko Deposit                  16Dec20:23 Antion Muldoon,,210,153974.34,Deposits,Deposit
16/12/2022,Osko Deposit                  16Dec18:21 Brunch A L,,30,153764.34,Deposits,Deposit
16/12/2022,Loan Repayment S.514.2655406.00,4347,,153734.34,Home & Property,Mortgage & Rent
15/12/2022,Visa Purchase                 12Dec Sq *Wrenglade Counse Adelaide,110,,158081.34,Retail & Personal,Medical & Personal care
15/12/2022,Visa Purchase                 13Dec Jaycar Electronics   Adelaide,58.85,,158191.34,Home & Property,Technology & Appliances
15/12/2022,Visa Purchase                 12Dec Bakery On O'Connell  North Ade,15.7,,158250.19,Food & Beverage,Food & Groceries
15/12/2022,Visa Purchase                 13Dec Hai Hoang Nguyen     Adelaide,8,,158265.89,Food & Beverage,Dining out
15/12/2022,Osko Withdrawal               15Dec15:31 140125 For Order 140125 Ozsmoke,51.8,,158273.89,Withdrawals & Transfers,Withdrawal
14/12/2022,Visa Purchase                 12Dec Ndc Service Co Pty L North Ade,1080,,158325.69,Retail & Personal,Medical & Personal care
14/12/2022,Visa Purchase                 11Dec Bunnings 337000      Prospect,77.82,,159405.69,Home & Property,Maintenance
14/12/2022,Visa Purchase                 10Dec Foodworks North Adel North Ade,32.17,,159483.51,Food & Beverage,Food & Groceries
14/12/2022,Visa Purchase                 12Dec Funk Coffee And Food Adelaide,6,,159515.68,Food & Beverage,Beverages
14/12/2022,Visa Purchase                 12Dec Shijia Service Pty L Adelaide,5,,159521.68,Food & Beverage,Food & Groceries
14/12/2022,Visa Purchase                 11Dec Prospect Blair Athol Hampstead,3.5,,159526.68,Bills & Payments,Memberships
14/12/2022,Osko Withdrawal               14Dec11:39 139989 Ozsmoke,162.3,,159530.18,Withdrawals & Transfers,Withdrawal
13/12/2022,Visa Purchase                 10Dec Alh Venues/27-29 Ebe Adelaide,88.8,,159692.48,Transport & Travel,Hotels and Accommodation
13/12/2022,Visa Purchase                 10Dec Bws/123 Oconnell Str Nrth Adel,74,,159781.28,Food & Beverage,Beverages
13/12/2022,Visa Purchase                 08Dec Venuetix Pty Ltd     Torrensvi,26,,159855.28,Home & Property,Services & Tradespeople
13/12/2022,Visa Purchase                 08Dec Venuetix Pty Ltd     Torrensvi,26,,159881.28,Home & Property,Services & Tradespeople
13/12/2022,Visa Purchase                 09Dec Bakery On O'Connell  North Ade,22,,159907.28,Food & Beverage,Food & Groceries
13/12/2022,Visa Purchase                 10Dec Bakery On O'Connell  North Ade,11,,159929.28,Food & Beverage,Food & Groceries
13/12/2022,Visa Purchase                 10Dec The Austral          Adelaide,10,,159940.28,Food & Beverage,Dining out
12/12/2022,Visa Purchase                 09Dec Myrepublic           612831768,107,,159950.28,Bills & Payments,Telecommunications
12/12/2022,Visa Purchase                 08Dec Bside Merchandising  Marrickvi,60,,160057.28,Retail & Personal,Retail (shopping)
12/12/2022,Visa Purchase                 08Dec Ampm Mile End 5937   Mile End,33.39,,160117.28,Transport & Travel,Petrol
12/12/2022,Visa Purchase                 08Dec Adelaide Pho         Adelaide,21,,160150.67,Food & Beverage,Dining out
12/12/2022,Visa Purchase                 08Dec Cumberland Arms Hote Adelaide,9.5,,160171.67,Food & Beverage,Beverages
12/12/2022,Eftpos Debit                  12Dec20:47 Beem It\,30,,160181.17,Withdrawals & Transfers,Funds transfer
12/12/2022,Atm Withdrawal                11Dec20:59 Cba\Prospect Sa                       Au,1200,,160211.17,Withdrawals & Transfers,ATM & EFTPOS
12/12/2022,Osko Deposit                  11Dec16:56 A L,,50,161411.17,Deposits,Deposit
12/12/2022,Osko Withdrawal               11Dec16:54 Al,260,,161361.17,Withdrawals & Transfers,Withdrawal
10/12/2022,Visa Purchase                 09Dec Medibank Phi Debit   Melbourne,521,,161621.17,Bills & Payments,Insurance
10/12/2022,Visa Purchase                 07Dec Jb Hi Fi Adelaide Ci Adelaide,198,,162142.17,Home & Property,Technology & Appliances
10/12/2022,Visa Purchase                 08Dec Adelaide Health Care Adelaide,86.35,,162340.17,Retail & Personal,Medical & Personal care
10/12/2022,Visa Purchase                 08Dec Mile End Hotel App   Mile End,22.8,,162426.52,Food & Beverage,Beverages
10/12/2022,Visa Purchase                 08Dec Mile End Hotel App   Mile End,22.8,,162449.32,Food & Beverage,Beverages
10/12/2022,Visa Purchase                 06Dec Caltex North Adelaid North Ade,3.5,,162472.12,Transport & Travel,Petrol
10/12/2022,Osko Withdrawal               10Dec12:55 Al,350,,162475.62,Withdrawals & Transfers,Withdrawal
9/12/2022,Visa Purchase                 06Dec Bakery On O'Connell  North Ade,23.7,,162825.62,Food & Beverage,Food & Groceries
9/12/2022,Visa Purchase                 07Dec City Bbq & Yum Cha P Sa Sa,17.6,,162849.32,Food & Beverage,Dining out
9/12/2022,Visa Purchase                 07Dec Funk Coffee And Food Adelaide,6,,162866.92,Food & Beverage,Beverages
8/12/2022,American Express 376012649071009,3330.83,,162872.92,Bills & Payments,Expenses & Payments
8/12/2022,Visa Purchase                 06Dec Raa                  Mile End,20.83,,166203.75,Transport & Travel,Vehicle Expenses
8/12/2022,Visa Purchase                 05Dec Bakery On O'Connell  North Ade,17.7,,166224.58,Food & Beverage,Food & Groceries
8/12/2022,Visa Purchase                 06Dec Smgb Grenfell St     Adelaide,17.5,,166242.28,Bills & Payments,Gifts & Donations
8/12/2022,Visa Purchase                 06Dec Funk Coffee And Food Adelaide,6,,166259.78,Food & Beverage,Beverages
8/12/2022,Mcare Benefits 457158271 Gywq,,39.75,166265.78,Government payments,Centrelink payments
7/12/2022,Visa Purchase                 05Dec Bws/123 Oconnell Str Nrth Adel,68.5,,166226.03,Food & Beverage,Beverages
7/12/2022,Visa Purchase                 05Dec Pasta Go Go North Ad North Ade,12.9,,166294.53,Food & Beverage,Dining out
7/12/2022,Osko Deposit                  07Dec21:03 A L,,240,166307.43,Deposits,Deposit
6/12/2022,Visa Purchase                 04Dec Sp Ozsmartthings     Sydney,69.98,,166067.43,Home & Property,Technology & Appliances
6/12/2022,Visa Purchase                 04Dec Big W/38 South Road  Torrensvi,65,,166137.41,Retail & Personal,Retail (shopping)
6/12/2022,Visa Purchase                 03Dec Jaycar Electronics   Adelaide,49.85,,166202.41,Home & Property,Technology & Appliances
6/12/2022,Visa Purchase                 01Dec Foodworks North Adel North Ade,42.57,,166252.26,Food & Beverage,Food & Groceries
6/12/2022,Visa Purchase                 03Dec Jaycar Electronics   Adelaide,39.95,,166294.83,Home & Property,Technology & Appliances
6/12/2022,Visa Purchase                 03Dec Bakery On O'Connell  North Ade,17.5,,166334.78,Food & Beverage,Food & Groceries
6/12/2022,Visa Purchase                 03Dec Bakery On O'Connell  North Ade,17.2,,166352.28,Food & Beverage,Food & Groceries
6/12/2022,Visa Purchase                 03Dec Pasta Go Go North Ad North Ade,14.4,,166369.48,Food & Beverage,Dining out
6/12/2022,Osko Withdrawal               06Dec17:19 Al,90,,166383.88,Withdrawals & Transfers,Withdrawal
6/12/2022,Osko Withdrawal               06Dec01:40 Al,500,,166473.88,Withdrawals & Transfers,Withdrawal
5/12/2022,Visa Purchase                 02Dec North Adelaide Fitne East Hill,27.9,,166973.88,Retail & Personal,Health & Fitness
5/12/2022,Atm Operator Fee Wdl          05Dec07:36 Atmx 139 Oconnell St   North Adelaid08Au,3,,167001.78,Fees & Charges,Fees & Charges
5/12/2022,Atm Withdrawal                05Dec07:36 Atmx 139 Oconnell St   North Adelaid08Au,1000,,167004.78,Withdrawals & Transfers,ATM & EFTPOS
3/12/2022,Visa Purchase                 01Dec Bws/123 Oconnell Str Nrth Adel,49,,168004.78,Food & Beverage,Beverages
3/12/2022,Visa Purchase                 30Nov Cumberland Arms Hote Adelaide,9.5,,168053.78,Food & Beverage,Beverages
3/12/2022,Visa Purchase                 29Nov Caltex North Adelaid North Ade,7,,168063.28,Transport & Travel,Petrol
2/12/2022,Visa Purchase                 30Nov Sp Rasp-Pi-Aus       Berowra,301.96,,168070.28,Home & Property,Technology & Appliances
2/12/2022,Visa Purchase                 29Nov Bakery On O'Connell  North Ade,17.2,,168372.24,Food & Beverage,Food & Groceries
2/12/2022,Visa Purchase                 30Nov City Bbq & Yum Cha P Sa Sa,16,,168389.44,Food & Beverage,Dining out
2/12/2022,Visa Purchase                 30Nov Shijia Service Pty L Adelaide,9.3,,168405.44,Food & Beverage,Food & Groceries
2/12/2022,Visa Purchase                 28Nov Caltex North Adelaid North Ade,5.5,,168414.74,Transport & Travel,Petrol
2/12/2022,Osko Deposit                  02Dec16:50 A L,,30,168420.24,Deposits,Deposit
2/12/2022,Osko Withdrawal               02Dec09:42 Ea Maul,300,,168390.24,Withdrawals & Transfers,Withdrawal
2/12/2022,Osko Withdrawal               01Dec23:07 Ada Oliver Dearman,150,,168690.24,Withdrawals & Transfers,Withdrawal
1/12/2022,Visa Purchase                 29Nov V/Cellars 3327       N Adelaid,118,,168840.24,Food & Beverage,Beverages
1/12/2022,Visa Purchase                 28Nov Sq *Wrenglade Counse Adelaide,110,,168958.24,Retail & Personal,Medical & Personal care
1/12/2022,Visa Purchase                 29Nov Gt & Hg Pty Ltd      North Ade,35.93,,169068.24,Food & Beverage,Food & Groceries
1/12/2022,Visa Purchase                 29Nov Raa                  Mile End,33.75,,169104.17,Transport & Travel,Vehicle Expenses
1/12/2022,Visa Purchase                 29Nov Tynte Street Quality North Ade,25.8,,169137.92,Food & Beverage,Food & Groceries
1/12/2022,Visa Purchase                 29Nov Raa                  Mile End,16.58,,169163.72,Transport & Travel,Vehicle Expenses
1/12/2022,Visa Purchase                 29Nov Funk Coffee And Food Adelaide,6,,169180.3,Food & Beverage,Beverages
1/12/2022,Visa Purchase                 29Nov Bakers Delight       North Ade,3.5,,169186.3,Food & Beverage,Food & Groceries
1/12/2022,Property Managme Rent,,1122.52,169189.8,Deposits,Deposit
1/12/2022,Osko Withdrawal               01Dec21:55 Ada Oliver Dearman,250,,168067.28,Withdrawals & Transfers,Withdrawal
1/12/2022,Atm Operator Fee Wdl          01Dec10:09 Atmx 139 Oconnell St   North Adelaid08Au,3,,168317.28,Fees & Charges,Fees & Charges
1/12/2022,Atm Withdrawal                01Dec10:09 Atmx 139 Oconnell St   North Adelaid08Au,1000,,168320.28,Withdrawals & Transfers,ATM & EFTPOS
1/12/2022,Atm Operator Fee Wdl          01Dec10:08 Atmx 139 Oconnell St   North Adelaid08Au,3,,169320.28,Fees & Charges,Fees & Charges
1/12/2022,Atm Withdrawal                01Dec10:08 Atmx 139 Oconnell St   North Adelaid08Au,1000,,169323.28,Withdrawals & Transfers,ATM & EFTPOS
1/12/2022,Internet Withdrawal           01Dec07:04 To 0280074830940,7956.91,,170323.28,Withdrawals & Transfers,Funds transfer
1/12/2022,Tfr Wdl BPAY Internet         01Dec06:12 111534              City Of Adelaide,614.9,,178280.19,Bills & Payments,Tax payments
1/12/2022,Tfr Wdl BPAY Internet         01Dec06:12 440057              City Of Adelaide,538.75,,178895.09,Bills & Payments,Tax payments
30/11/2022,Visa Purchase                 27Nov The Exford Hotel     Melbourne,61.6,,179433.84,Food & Beverage,Beverages
30/11/2022,Visa Purchase                 25Nov The Exford Hotel     Melbourne,25.4,,179495.44,Food & Beverage,Beverages
30/11/2022,Visa Purchase                 27Nov International Diethn Melbourne,16,,179520.84,Food & Beverage,Food & Groceries
29/11/2022,Visa Purchase                 26Nov Sq *Gojo Event Manag Kew East,56,,179536.84,Entertainment & Recreation,Catering
29/11/2022,Visa Purchase                 26Nov Sq *Gojo Event Manag Kew East,28,,179592.84,Entertainment & Recreation,Catering
29/11/2022,Visa Purchase                 26Nov Sq *Gojo Event Manag Kew East,28,,179620.84,Entertainment & Recreation,Catering
29/11/2022,Visa Purchase                 26Nov Pickford Pharmacy    Carlton,21.95,,179648.84,Retail & Personal,Medical & Personal care
29/11/2022,Visa Purchase                 25Nov Sq *Huff N Puff      Melbourne,15,,179670.79,Retail & Personal,Retail (shopping)
29/11/2022,Visa Purchase                 26Nov 272 Lygon Street Pty Carlton,9.62,,179685.79,Food & Beverage,Food & Groceries
28/11/2022,Visa Purchase                 24Nov Chemist Warehouse    Docklands,78.38,,179695.41,Retail & Personal,Medical & Personal care
28/11/2022,Visa Purchase                 24Nov The Exford Hotel     Melbourne,53.5,,179773.79,Food & Beverage,Beverages
28/11/2022,Visa Purchase                 25Nov Liquorland 3845      Melbourne,51,,179827.29,Food & Beverage,Beverages
28/11/2022,Visa Purchase                 24Nov Myki Disccntr Scs Ds Melbourne,50,,179878.29,Transport & Travel,Public transport
28/11/2022,Visa Purchase                 24Nov Mrs Mills Touring Pt Carlton,28.47,,179928.29,Food & Beverage,Dining out
28/11/2022,Visa Purchase                 24Nov Ezymart Strn Cros Pl Docklands,10.14,,179956.76,Food & Beverage,Food & Groceries
28/11/2022,Visa Purchase                 25Nov Maxims  Cake And Pas Melbourne,6.57,,179966.9,Food & Beverage,Food & Groceries
28/11/2022,Visa Purchase                 24Nov Ahh Vic Pty Ltd      Melbourne,5,,179973.47,Food & Beverage,Food & Groceries
26/11/2022,Visa Purchase                 23Nov Harvey Norman Av/It  Adelaide,72.9,,179978.47,Retail & Personal,Retail (shopping)
26/11/2022,Visa Purchase                 23Nov Harvey Norman Av/It  Adelaide,26.1,,180051.37,Retail & Personal,Retail (shopping)
25/11/2022,Visa Purchase                 21Nov Foodworks North Adel North Ade,24.24,,180077.47,Food & Beverage,Food & Groceries
25/11/2022,Visa Purchase                 23Nov Airport Pharmacy     Adelaide,15.95,,180101.71,Retail & Personal,Medical & Personal care
25/11/2022,Visa Purchase                 23Nov Shijia Service Pty L Adelaide,7,,180117.66,Food & Beverage,Food & Groceries
25/11/2022,Osko Withdrawal               25Nov18:18 Al,500,,180124.66,Withdrawals & Transfers,Withdrawal
25/11/2022,Osko Withdrawal               25Nov16:22 Coffee Al,600,,180624.66,Withdrawals & Transfers,Withdrawal
24/11/2022,Visa Purchase                 22Nov Optus Billing Autopa Macquarie,92.75,,181224.66,Bills & Payments,Telecommunications
24/11/2022,Visa Purchase                 21Nov Bakery On O'Connell  North Ade,15.8,,181317.41,Food & Beverage,Food & Groceries
24/11/2022,Visa Purchase                 21Nov Wellington Hotel     North Ade,14.4,,181333.21,Food & Beverage,Beverages
23/11/2022,Visa Purchase                 20Nov Citizen Hotel Restau Adelaide,99.25,,181347.61,Food & Beverage,Dining out
23/11/2022,Visa Purchase                 20Nov Myrepublic           612831768,99,,181446.86,Bills & Payments,Telecommunications
23/11/2022,Visa Purchase                 21Nov Bws/123 Oconnell Str Nrth Adel,48,,181545.86,Food & Beverage,Beverages
23/11/2022,Visa Purchase                 21Nov City Bbq & Yum Cha P Sa Sa,16,,181593.86,Food & Beverage,Dining out
21/11/2022,Allianz Aust 1Rd221368014122325,129.35,,181609.86,Bills & Payments,Insurance
21/11/2022,Visa Purchase                 18Nov Liquorland 6078      Adelaide,51,,181739.21,Food & Beverage,Beverages
21/11/2022,Visa Purchase                 18Nov North Adelaide Fitne East Hill,27.9,,181790.21,Retail & Personal,Health & Fitness
21/11/2022,Visa Purchase                 16Nov Caltex North Adelaid North Ade,27.87,,181818.11,Transport & Travel,Petrol
21/11/2022,Allianz Aust 1Rd220985014122325,19.44,,181845.98,Bills & Payments,Insurance
21/11/2022,Atm Withdrawal                21Nov13:03 Rundle Place Os          Adelaide     Au,600,,181865.42,Withdrawals & Transfers,ATM & EFTPOS
19/11/2022,Visa Purchase                 16Nov Bakery On O'Connell  North Ade,5.5,,182465.42,Food & Beverage,Food & Groceries
18/11/2022,Visa Purchase                 16Nov Bws/123 Oconnell Str Nrth Adel,53,,182470.92,Food & Beverage,Beverages
18/11/2022,Visa Purchase                 16Nov Gt & Hg Pty Ltd      North Ade,19,,182523.92,Food & Beverage,Food & Groceries
18/11/2022,Visa Purchase                 16Nov Tynte Street Quality North Ade,16.51,,182542.92,Food & Beverage,Food & Groceries
18/11/2022,Visa Purchase                 16Nov Funk Coffee And Food Adelaide,6,,182559.43,Food & Beverage,Beverages
18/11/2022,Cardless Atm Withdrawal       18Nov12:24 Rundle Place Os          Adelaide     Au,500,,182565.43,Withdrawals & Transfers,ATM & EFTPOS
18/11/2022,Tfr Wdl BPAY Internet         18Nov06:31 4601843800646786    Banksa Cards,500,,183065.43,Withdrawals & Transfers,Withdrawal
17/11/2022,Visa Purchase                 15Nov City Bbq & Yum Cha P Sa Sa,16,,183565.43,Food & Beverage,Dining out
17/11/2022,Visa Purchase                 15Nov Shijia Service Pty L Adelaide,10.2,,183581.43,Food & Beverage,Food & Groceries
16/11/2022,Visa Purchase                 14Nov Raa                  Mile End,70.66,,183591.63,Transport & Travel,Vehicle Expenses
16/11/2022,Visa Purchase                 14Nov Liquorland 6078      Adelaide,28,,183662.29,Food & Beverage,Beverages
16/11/2022,Visa Purchase                 14Nov Nth Adel Foodland    North Ade,18.34,,183690.29,Food & Beverage,Food & Groceries
16/11/2022,Loan Repayment S.514.2655406.00,4116,,183708.63,Home & Property,Mortgage & Rent
15/11/2022,Visa Purchase                 12Nov Bakery On O'Connell  North Ade,28.5,,187824.63,Food & Beverage,Food & Groceries
15/11/2022,Visa Purchase                 10Nov Foodworks North Adel North Ade,25.1,,187853.13,Food & Beverage,Food & Groceries
15/11/2022,Visa Purchase                 11Nov C&S Htel Pty Ltd     Adelaide,11.08,,187878.23,Transport & Travel,Hotels and Accommodation
15/11/2022,Visa Purchase                 10Nov Caltex North Adelaid North Ade,5.5,,187889.31,Transport & Travel,Petrol
15/11/2022,Property Managme Rent,,2289.04,187894.81,Deposits,Deposit
12/11/2022,Visa Purchase                 10Nov Bws/123 Oconnell Str Nrth Adel,49,,185605.77,Food & Beverage,Beverages
12/11/2022,Osko Withdrawal               12Nov16:00 Michelle,100,,185654.77,Withdrawals & Transfers,Withdrawal
11/11/2022,Osko Deposit                  11Nov07:55 Courtney A Girdler,,350,185754.77,Deposits,Deposit
10/11/2022,Visa Purchase                 09Nov Medibank Phi Debit   Melbourne,521,,185404.77,Bills & Payments,Insurance
10/11/2022,Visa Purchase                 08Nov Myrepublic           612831768,107,,185925.77,Bills & Payments,Telecommunications
10/11/2022,Visa Purchase                 08Nov Linda Erica Shackloc Adelaide,8.9,,186032.77,Retail & Personal,Medical & Personal care
10/11/2022,Visa Purchase                 08Nov Funk Coffee And Food Adelaide,6,,186041.67,Food & Beverage,Beverages
10/11/2022,Visa Purchase                 06Nov Caltex North Adelaid North Ade,5.5,,186047.67,Transport & Travel,Petrol
10/11/2022,Visa Purchase                 08Nov Shijia Service Pty L Adelaide,4.5,,186053.17,Food & Beverage,Food & Groceries
9/11/2022,Visa Purchase                 07Nov Raa                  Mile End,20.83,,186057.67,Transport & Travel,Vehicle Expenses
9/11/2022,Visa Purchase                 06Nov Gt & Hg Pty Ltd      North Ade,6.04,,186078.5,Food & Beverage,Food & Groceries
9/11/2022,Osko Deposit                  09Nov13:42 Jodi Jodi Jodi Godby,,260,186084.54,Deposits,Deposit
9/11/2022,Atm Withdrawal                09Nov10:09 Rundle Place Os          Adelaide     Au,1500,,185824.54,Withdrawals & Transfers,ATM & EFTPOS
9/11/2022,Osko Deposit                  09Nov06:58 So Sorry Kellie Bond,,600,187324.54,Deposits,Deposit
8/11/2022,Visa Purchase                 04Nov Jb Hi Fi Adelaide Ci Adelaide,79,,186724.54,Home & Property,Technology & Appliances
8/11/2022,Visa Purchase                 05Nov Tynte Street Quality North Ade,56.8,,186803.54,Food & Beverage,Food & Groceries
8/11/2022,Visa Purchase                 06Nov Bws/123 Oconnell Str Nrth Adel,53,,186860.34,Food & Beverage,Beverages
8/11/2022,Visa Purchase                 05Nov Alh Venues/60 Oconne Nrth Adel,26.5,,186913.34,Transport & Travel,Hotels and Accommodation
8/11/2022,Visa Purchase                 05Nov Alh Venues/60 Oconne Nrth Adel,17.5,,186939.84,Transport & Travel,Hotels and Accommodation
8/11/2022,Visa Purchase                 05Nov Bakery On O'Connell  North Ade,17.5,,186957.34,Food & Beverage,Food & Groceries
8/11/2022,Visa Purchase                 04Nov Caltex North Adelaid North Ade,5.5,,186974.84,Transport & Travel,Petrol
7/11/2022,American Express 376012649071009,1616.85,,186980.34,Bills & Payments,Expenses & Payments
7/11/2022,Visa Purchase                 04Nov Bws/123 Oconnell Str Nrth Adel,74,,188597.19,Food & Beverage,Beverages
7/11/2022,Visa Purchase                 03Nov Wellington Hotel     North Ade,40,,188671.19,Food & Beverage,Beverages
7/11/2022,Visa Purchase                 04Nov North Adelaide Fitne East Hill,27.9,,188711.19,Retail & Personal,Health & Fitness
7/11/2022,Visa Purchase                 03Nov Bakery On O'Connell  North Ade,17.1,,188739.09,Food & Beverage,Food & Groceries
7/11/2022,Visa Purchase                 02Nov Foodworks North Adel North Ade,16.45,,188756.19,Food & Beverage,Food & Groceries
7/11/2022,Visa Purchase                 04Nov City Bbq & Yum Cha P Sa Sa,16,,188772.64,Food & Beverage,Dining out
7/11/2022,Visa Purchase                 02Nov Caltex North Adelaid North Ade,12.5,,188788.64,Transport & Travel,Petrol
7/11/2022,Osko Withdrawal               07Nov11:39 Ad K Bond,600,,188801.14,Withdrawals & Transfers,Withdrawal
7/11/2022,Osko Withdrawal               05Nov22:13 Al,5000,,189401.14,Withdrawals & Transfers,Withdrawal
5/11/2022,Visa Purchase                 01Nov Caltex North Adelaid North Ade,5.2,,194401.14,Transport & Travel,Petrol
4/11/2022,Visa Purchase                 01Nov Governor Hindmarsh H Hindmarsh,90,,194406.34,Food & Beverage,Beverages
4/11/2022,Visa Purchase                 01Nov Governor Hindmarsh H Hindmarsh,25.5,,194496.34,Food & Beverage,Beverages
4/11/2022,Visa Purchase                 02Nov Tynte Street Quality North Ade,25,,194521.84,Food & Beverage,Food & Groceries
4/11/2022,Visa Purchase                 01Nov Governor Hindmarsh H Hindmarsh,20,,194546.84,Food & Beverage,Beverages
4/11/2022,Visa Purchase                 01Nov Sq *Nanyang Cafe ??? Adelaide,19.5,,194566.84,Food & Beverage,Dining out
4/11/2022,Visa Purchase                 02Nov Shijia Service Pty L Adelaide,13.8,,194586.34,Food & Beverage,Food & Groceries
4/11/2022,Eftpos Debit                  04Nov22:07 Beem It\,600,,194600.14,Withdrawals & Transfers,Funds transfer
4/11/2022,Eftpos Debit                  04Nov20:46 Beem It\,500,,195200.14,Withdrawals & Transfers,Funds transfer
4/11/2022,Cardless Atm Withdrawal       04Nov10:15 Rundle Place Os          Adelaide     Au,500,,195700.14,Withdrawals & Transfers,ATM & EFTPOS
3/11/2022,Visa Purchase                 01Nov Funk Coffee And Food Adelaide,6,,196200.14,Food & Beverage,Beverages
3/11/2022,Eftpos Debit                  03Nov18:50 Beem It\,300,,196206.14,Withdrawals & Transfers,Funds transfer
2/11/2022,Visa Purchase                 29Oct Caledonian Hotel Nor North Ade,126.15,,196506.14,Food & Beverage,Dining out
2/11/2022,Visa Purchase                 31Oct Bws/123 Oconnell Str Nrth Adel,86,,196632.29,Food & Beverage,Beverages
2/11/2022,Visa Purchase                 31Oct Raa                  Mile End,40.16,,196718.29,Transport & Travel,Vehicle Expenses
2/11/2022,Visa Purchase                 31Oct Jeff Ramsey Pharmaci North Ade,39.01,,196758.45,Retail & Personal,Medical & Personal care
2/11/2022,Visa Purchase                 31Oct Gt & Hg Pty Ltd      North Ade,34.73,,196797.46,Food & Beverage,Food & Groceries
2/11/2022,Visa Purchase                 31Oct Liquorland 6078      Adelaide,23,,196832.19,Food & Beverage,Beverages
2/11/2022,Visa Purchase                 31Oct Raa                  Mile End,16.62,,196855.19,Transport & Travel,Vehicle Expenses
2/11/2022,Visa Purchase                 29Oct Caltex North Adelaid North Ade,13.4,,196871.81,Transport & Travel,Petrol
2/11/2022,Visa Purchase                 31Oct Funk Coffee And Food Adelaide,6,,196885.21,Food & Beverage,Beverages
2/11/2022,Visa Purchase                 31Oct Bakers Delight       North Ade,3.2,,196891.21,Food & Beverage,Food & Groceries
1/11/2022,Visa Purchase                 28Oct South Australian Wat Adelaide,334.48,,196894.41,Bills & Payments,Utilities & Rates
1/11/2022,Foreign Currency Conversn Fee,4.69,,197228.89,Fees & Charges,Fees & Charges
1/11/2022,Visa Purchase O/Seas          28Oct Usd99.95 Expressvpn.Com,156.49,,197233.58,Home & Property,Technology & Appliances
1/11/2022,Osko Withdrawal               31Oct22:29 Per Conversation Paymen C Bonnes,100,,197390.07,Withdrawals & Transfers,Withdrawal
31/10/2022,Visa Purchase                 27Oct Dumplings R Us       Adelaide,76.7,,197490.07,Food & Beverage,Dining out
31/10/2022,Visa Purchase                 27Oct Griffins Head Hotel  Adelaide,23.9,,197566.77,Food & Beverage,Beverages
31/10/2022,Visa Purchase                 26Oct Foodworks North Adel North Ade,8.49,,197590.67,Food & Beverage,Food & Groceries
31/10/2022,Property Managme Rent,,1215.32,197599.16,Deposits,Deposit
31/10/2022,Eftpos Debit                  30Oct13:08 Beem It\,1000,,196383.84,Withdrawals & Transfers,Funds transfer
29/10/2022,Visa Purchase                 26Oct Oxford Hotel         North Ade,17,,197383.84,Food & Beverage,Dining out
29/10/2022,Visa Purchase                 26Oct Bakery On O'Connell  North Ade,5.5,,197400.84,Food & Beverage,Food & Groceries
28/10/2022,Visa Purchase                 24Oct Foodworks North Adel North Ade,80.89,,197406.34,Food & Beverage,Food & Groceries
28/10/2022,Visa Purchase                 26Oct V/Cellars 3327       N Adelaid,45,,197487.23,Food & Beverage,Beverages
28/10/2022,Visa Purchase                 26Oct Nth Adel Foodland    North Ade,35.51,,197532.23,Food & Beverage,Food & Groceries
27/10/2022,Tfr Wdl BPAY Internet         27Oct16:26 5092458412          Revsa - Esl,238.6,,197567.74,Bills & Payments,Tax payments
26/10/2022,Visa Purchase                 22Oct Foodworks North Adel North Ade,70.98,,197806.34,Food & Beverage,Food & Groceries
26/10/2022,Visa Purchase                 23Oct Wellington Hotel     North Ade,56,,197877.32,Food & Beverage,Beverages
26/10/2022,Visa Purchase                 24Oct Bws/123 Oconnell Str Nrth Adel,54,,197933.32,Food & Beverage,Beverages
26/10/2022,Eftpos Debit                  26Oct12:21 Beem It\,300,,197987.32,Withdrawals & Transfers,Funds transfer
26/10/2022,Osko Withdrawal               26Oct12:20 Ada Rent Community Chest,750,,198287.32,Withdrawals & Transfers,Withdrawal
25/10/2022,Visa Purchase                 22Oct Bws/123 Oconnell Str Nrth Adel,198,,199037.32,Food & Beverage,Beverages
25/10/2022,Visa Purchase                 22Oct Optus Billing Autopa Macquarie,92.75,,199235.32,Bills & Payments,Telecommunications
25/10/2022,Visa Purchase                 22Oct Bakery On O'Connell  North Ade,18,,199328.07,Food & Beverage,Food & Groceries
25/10/2022,Visa Purchase                 20Oct Foodworks North Adel North Ade,13.48,,199346.07,Food & Beverage,Food & Groceries
25/10/2022,Visa Purchase                 21Oct Bakery On O'Connell  North Ade,11.7,,199359.55,Food & Beverage,Food & Groceries
25/10/2022,Eftpos Debit                  25Oct11:30 Beem It\,50,,199371.25,Withdrawals & Transfers,Funds transfer
24/10/2022,Visa Purchase                 21Oct North Adelaide Fitne East Hill,27.9,,199421.25,Retail & Personal,Health & Fitness
24/10/2022,Visa Purchase                 21Oct Pasta Go Go North Ad North Ade,12.9,,199449.15,Food & Beverage,Dining out
24/10/2022,Visa Purchase                 20Oct Caltex North Adelaid North Ade,10.4,,199462.05,Transport & Travel,Petrol
22/10/2022,Visa Purchase                 20Oct Myrepublic           612831768,99,,199472.45,Bills & Payments,Telecommunications
22/10/2022,Visa Purchase                 20Oct Bws/123 Oconnell Str Nrth Adel,94,,199571.45,Food & Beverage,Beverages
22/10/2022,Visa Purchase                 19Oct North Adelaide Burge North Ade,10.7,,199665.45,Food & Beverage,Dining out
21/10/2022,Allianz Aust 1Rd221368010622294,129.35,,199676.15,Bills & Payments,Insurance
21/10/2022,Visa Purchase                 19Oct V/Cellars 3327       N Adelaid,23,,199805.5,Food & Beverage,Beverages
21/10/2022,Allianz Aust 1Rd220985010622294,19.44,,199828.5,Bills & Payments,Insurance
21/10/2022,Visa Purchase                 18Oct Bakery On O'Connell  North Ade,17.5,,199847.94,Food & Beverage,Food & Groceries
21/10/2022,Eftpos Debit                  21Oct15:35 Beem It\,500,,199865.44,Withdrawals & Transfers,Funds transfer
20/10/2022,Visa Purchase                 17Oct Bakery On O'Connell  North Ade,17.5,,200365.44,Food & Beverage,Food & Groceries
19/10/2022,Visa Purchase                 17Oct Nth Adel Foodland    North Ade,76.43,,200382.94,Food & Beverage,Food & Groceries
19/10/2022,Visa Purchase                 17Oct Ndc Service Co Pty L North Ade,68.3,,200459.37,Retail & Personal,Medical & Personal care
19/10/2022,Visa Purchase                 17Oct Jeff Ramsey Pharmacy North Ade,26.96,,200527.67,Retail & Personal,Medical & Personal care
19/10/2022,Visa Purchase                 15Oct Foodworks North Adel North Ade,16.98,,200554.63,Food & Beverage,Food & Groceries
18/10/2022,American Express 376012649071009,983.44,,200571.61,Bills & Payments,Expenses & Payments
18/10/2022,Visa Purchase                 14Oct Raa                  Mile End,70.74,,201555.05,Transport & Travel,Vehicle Expenses
18/10/2022,Visa Purchase                 15Oct Bws/123 Oconnell Str Nrth Adel,25,,201625.79,Food & Beverage,Beverages
18/10/2022,Visa Purchase                 15Oct Bakery On O'Connell  North Ade,18,,201650.79,Food & Beverage,Food & Groceries
18/10/2022,Atm Operator Fee Wdl          18Oct10:20 Atmx 139 Oconnell St   North Adelaid08Au,3,,201668.79,Fees & Charges,Fees & Charges
18/10/2022,Atm Withdrawal                18Oct10:20 Atmx 139 Oconnell St   North Adelaid08Au,700,,201671.79,Withdrawals & Transfers,ATM & EFTPOS
18/10/2022,Eftpos Debit                  17Oct22:41 Beem It\,300,,202371.79,Withdrawals & Transfers,Funds transfer
17/10/2022,Visa Purchase                 13Oct Gsh Union Pty Ltd    North Ade,32.2,,202671.79,Food & Beverage,Food & Groceries
17/10/2022,Property Managme Rent,,1144.52,202703.99,Deposits,Deposit
17/10/2022,Loan Repayment S.514.2655406.00,3891,,201559.47,Home & Property,Mortgage & Rent
15/10/2022,Visa Purchase                 13Oct Bws/123 Oconnell Str Nrth Adel,113,,205450.47,Food & Beverage,Beverages
15/10/2022,Visa Purchase                 11Oct Foodworks North Adel North Ade,28.07,,205563.47,Food & Beverage,Food & Groceries
15/10/2022,Visa Purchase                 12Oct Bakery On O'Connell  North Ade,23.7,,205591.54,Food & Beverage,Food & Groceries
14/10/2022,Visa Purchase                 12Oct Nth Adel Foodland    North Ade,95.14,,205615.24,Food & Beverage,Food & Groceries
14/10/2022,Visa Purchase                 12Oct V/Cellars 3327       N Adelaid,45,,205710.38,Food & Beverage,Beverages
13/10/2022,Visa Purchase                 10Oct North Adelaide Burge North Ade,15.5,,205755.38,Food & Beverage,Dining out
13/10/2022,Visa Purchase                 11Oct Pasta Go Go North Ad North Ade,12.9,,205770.88,Food & Beverage,Dining out
13/10/2022,Eftpos Debit                  13Oct21:23 Beem It\,500,,205783.78,Withdrawals & Transfers,Funds transfer
13/10/2022,Atm Operator Fee Wdl          13Oct18:33 Atmx 139 Oconnell St   North Adelaid08Au,2.8,,206283.78,Fees & Charges,Fees & Charges
13/10/2022,Atm Withdrawal                13Oct18:33 Atmx 139 Oconnell St   North Adelaid08Au,500,,206286.58,Withdrawals & Transfers,ATM & EFTPOS
13/10/2022,Atm Operator Fee Wdl          13Oct18:32 Atmx 139 Oconnell St   North Adelaid08Au,2.8,,206786.58,Fees & Charges,Fees & Charges
13/10/2022,Atm Withdrawal                13Oct18:32 Atmx 139 Oconnell St   North Adelaid08Au,500,,206789.38,Withdrawals & Transfers,ATM & EFTPOS
13/10/2022,Atm Operator Fee Wdl          13Oct18:28 Royal Oak Nth Adl     Nrth Adelaide   Au,2.5,,207289.38,Fees & Charges,Fees & Charges
13/10/2022,Atm Withdrawal                13Oct18:28 Royal Oak Nth Adl     Nrth Adelaide   Au,250,,207291.88,Withdrawals & Transfers,ATM & EFTPOS
12/10/2022,Visa Purchase                 09Oct Myrepublic           612831768,107,,207541.88,Bills & Payments,Telecommunications
12/10/2022,Visa Purchase                 08Oct Nth Adel Foodland    North Ade,68.84,,207648.88,Food & Beverage,Food & Groceries
12/10/2022,Visa Purchase                 10Oct Bws/123 Oconnell Str Nrth Adel,55,,207717.72,Food & Beverage,Beverages
12/10/2022,Visa Purchase                 10Oct Metro Convenience St Adelaide,15.21,,207772.72,Food & Beverage,Food & Groceries
12/10/2022,Visa Purchase                 10Oct Funk Coffee And Food Adelaide,6,,207787.93,Food & Beverage,Beverages
11/10/2022,Visa Purchase                 10Oct Medibank Phi Debit   Melbourne,521,,207793.93,Bills & Payments,Insurance
11/10/2022,Visa Purchase                 08Oct V/Cellars 3327       N Adelaid,100,,208314.93,Food & Beverage,Beverages
11/10/2022,Visa Purchase                 08Oct V/Cellars 3327       N Adelaid,100,,208414.93,Food & Beverage,Beverages
11/10/2022,Visa Purchase                 08Oct V/Cellars 3327       N Adelaid,100,,208514.93,Food & Beverage,Beverages
11/10/2022,Visa Purchase                 07Oct Harvey Norman Av/It  Adelaide,78.96,,208614.93,Retail & Personal,Retail (shopping)
11/10/2022,Visa Purchase                 07Oct Jb Hi Fi Adelaide Ci Adelaide,69.1,,208693.89,Home & Property,Technology & Appliances
11/10/2022,Visa Purchase                 08Oct V/Cellars 3327       N Adelaid,58,,208762.99,Food & Beverage,Beverages
11/10/2022,Visa Purchase                 08Oct Bakery On O'Connell  North Ade,17.5,,208820.99,Food & Beverage,Food & Groceries
10/10/2022,Visa Purchase                 07Oct North Adelaide Fitne East Hill,27.9,,208838.49,Retail & Personal,Health & Fitness
10/10/2022,Visa Purchase                 07Oct City Bbq & Yum Cha P Sa Sa,16,,208866.39,Food & Beverage,Dining out
10/10/2022,Visa Purchase                 07Oct Funk Coffee And Food Adelaide,6,,208882.39,Food & Beverage,Beverages
10/10/2022,Osko Withdrawal               09Oct07:37 As Discussed K Bond,700,,208888.39,Withdrawals & Transfers,Withdrawal
8/10/2022,Visa Purchase                 06Oct Otr Prospect 5951    Prospect,84.22,,209588.39,Transport & Travel,Petrol
8/10/2022,Visa Purchase                 05Oct Sq *Ricky's Chicken  North Ade,25.8,,209672.61,Food & Beverage,Dining out
8/10/2022,Visa Purchase                 06Oct Raa                  Mile End,20.83,,209698.41,Transport & Travel,Vehicle Expenses
8/10/2022,Visa Purchase                 05Oct Oxford Hotel         North Ade,8,,209719.24,Food & Beverage,Dining out
7/10/2022,Visa Purchase                 03Oct Foodworks North Adel North Ade,67.83,,209727.24,Food & Beverage,Food & Groceries
7/10/2022,Visa Purchase                 05Oct Bws/123 Oconnell Str Nrth Adel,25,,209795.07,Food & Beverage,Beverages
7/10/2022,Visa Purchase                 05Oct Funk Coffee And Food Adelaide,6,,209820.07,Food & Beverage,Beverages
7/10/2022,Atm Withdrawal                07Oct11:46 Rundle Place Os          Adelaide     Au,2000,,209826.07,Withdrawals & Transfers,ATM & EFTPOS
7/10/2022,Tfr Wdl BPAY Internet         07Oct06:56 4601843800646786    Banksa Cards,1500,,211826.07,Withdrawals & Transfers,Withdrawal
6/10/2022,Visa Purchase                 04Oct Funk Coffee And Food Adelaide,6,,213326.07,Food & Beverage,Beverages
5/10/2022,Visa Purchase                 02Oct Bakery On O'Connell  North Ade,17.5,,213332.07,Food & Beverage,Food & Groceries
4/10/2022,Visa Purchase                 30Sep Jarvis Subaru        Adelaide,824.25,,213349.57,Transport & Travel,Vehicle Expenses
4/10/2022,Visa Purchase                 02Oct Bws/123 Oconnell Str Nrth Adel,106,,214173.82,Food & Beverage,Beverages
4/10/2022,Visa Purchase                 02Oct Alh Venues/60 Oconne Nrth Adel,26,,214279.82,Transport & Travel,Hotels and Accommodation
4/10/2022,Visa Purchase                 02Oct Alh Venues/60 Oconne Nrth Adel,15.7,,214305.82,Transport & Travel,Hotels and Accommodation
3/10/2022,Visa Purchase                 28Sep Foodworks North Adel North Ade,51.7,,214321.52,Food & Beverage,Food & Groceries
3/10/2022,Visa Purchase                 30Sep Shijia Service Pty L Adelaide,19.8,,214373.22,Food & Beverage,Food & Groceries
3/10/2022,Internet Deposit              02Oct20:58 From 9000204517840,,4000,214393.02,Deposits,Deposit
1/10/2022,Visa Purchase                 29Sep Raa                  Mile End,40.16,,210393.02,Transport & Travel,Vehicle Expenses
1/10/2022,Visa Purchase                 29Sep Raa                  Mile End,15.66,,210433.18,Transport & Travel,Vehicle Expenses
1/10/2022,Visa Purchase                 29Sep Funk Coffee And Food Adelaide,5,,210448.84,Food & Beverage,Beverages
30/09/2022,Visa Purchase                 28Sep Bws/123 Oconnell Str Nrth Adel,179,,210453.84,Food & Beverage,Beverages
30/09/2022,Visa Purchase                 28Sep Woolworths/80-88 Run Rundle Ma,12.95,,210632.84,Food & Beverage,Food & Groceries
30/09/2022,Property Managme Rent,,1144.52,210645.79,Deposits,Deposit
30/09/2022,Atm Withdrawal                30Sep07:51 Banksa                Adelaide     5  Au,1000,,209501.27,Withdrawals & Transfers,ATM & EFTPOS
29/09/2022,Visa Purchase                 26Sep Bakery On O'Connell  North Ade,17.5,,210501.27,Food & Beverage,Food & Groceries
29/09/2022,Tfr Wdl BPAY Internet         29Sep01:25 4601843800646786    Banksa Cards,1000,,210518.77,Withdrawals & Transfers,Withdrawal
29/09/2022,Osko Withdrawal               28Sep22:55 Chance,500,,211518.77,Withdrawals & Transfers,Withdrawal
29/09/2022,Osko Withdrawal               28Sep22:53 Rent Community Chest,800,,212018.77,Withdrawals & Transfers,Withdrawal
28/09/2022,Visa Purchase                 24Sep Nth Adel Foodland    North Ade,67.43,,212818.77,Food & Beverage,Food & Groceries
28/09/2022,Visa Purchase                 25Sep Nth Adel Foodland    North Ade,57.69,,212886.2,Food & Beverage,Food & Groceries
28/09/2022,Visa Purchase                 26Sep Dan Murphy's/85-87 P St Peters,53.98,,212943.89,Food & Beverage,Beverages
28/09/2022,Visa Purchase                 24Sep Foodworks North Adel North Ade,9.98,,212997.87,Food & Beverage,Food & Groceries
27/09/2022,Visa Purchase                 25Sep V/Cellars 3327       N Adelaid,202,,213007.85,Food & Beverage,Beverages
27/09/2022,Visa Purchase                 24Sep Bws/123 Oconnell Str Nrth Adel,86,,213209.85,Food & Beverage,Beverages
26/09/2022,Visa Purchase                 23Sep Nth Adel Foodland    North Ade,28.37,,213295.85,Food & Beverage,Food & Groceries
26/09/2022,Visa Purchase                 23Sep Pasta Go Go North Ad North Ade,14.6,,213324.22,Food & Beverage,Dining out
26/09/2022,Visa Purchase                 23Sep North Adelaide Fitne East Hill,12.95,,213338.82,Retail & Personal,Health & Fitness
26/09/2022,Visa Purchase                 23Sep Funk Coffee And Food Adelaide,6,,213351.77,Food & Beverage,Beverages
26/09/2022,Eftpos Debit                  26Sep15:57 Beem It\,50,,213357.77,Withdrawals & Transfers,Funds transfer
24/09/2022,Visa Purchase                 22Sep Optus Billing Autopa Macquarie,172.75,,213407.77,Bills & Payments,Telecommunications
24/09/2022,Visa Purchase                 21Sep Bakery On O'Connell  North Ade,24.2,,213580.52,Food & Beverage,Food & Groceries
24/09/2022,Visa Purchase                 22Sep Bakery On O'Connell  North Ade,16.4,,213604.72,Food & Beverage,Food & Groceries
24/09/2022,Visa Purchase                 20Sep Foodworks North Adel North Ade,9.98,,213621.12,Food & Beverage,Food & Groceries
24/09/2022,Osko Withdrawal               24Sep20:06 K Bond,1200,,213631.1,Withdrawals & Transfers,Withdrawal
23/09/2022,Visa Purchase                 20Sep Myrepublic           612831768,99,,214831.1,Bills & Payments,Telecommunications
23/09/2022,Visa Purchase                 20Sep Jeff Ramsey Pharmacy North Ade,33.08,,214930.1,Retail & Personal,Medical & Personal care
23/09/2022,Visa Purchase                 20Sep Gt & Hg Pty Ltd      North Ade,25.19,,214963.18,Food & Beverage,Food & Groceries
23/09/2022,Visa Purchase                 18Sep Foodworks North Adel North Ade,10.99,,214988.37,Food & Beverage,Food & Groceries
23/09/2022,Ozforex Limited Maul,,29786,214999.36,Deposits,Deposit
23/09/2022,Eftpos Debit                  22Sep17:24 Beem It\,700,,185213.36,Withdrawals & Transfers,Funds transfer
21/09/2022,Allianz Aust 1Rd221368017122264,129.35,,185913.36,Bills & Payments,Insurance
21/09/2022,Visa Purchase                 17Sep Thuan Phat Supermktp Croydon P,111,,186042.71,Food & Beverage,Food & Groceries
21/09/2022,Visa Purchase                 19Sep Nth Adel Foodland    North Ade,58.76,,186153.71,Food & Beverage,Food & Groceries
21/09/2022,Allianz Aust 1Rd220985017122264,19.44,,186212.47,Bills & Payments,Insurance
21/09/2022,Visa Purchase                 18Sep Bakery On O'Connell  North Ade,17.5,,186231.91,Food & Beverage,Food & Groceries
21/09/2022,Visa Purchase                 18Sep North Adelaide Burge North Ade,15.5,,186249.41,Food & Beverage,Dining out
19/09/2022,Visa Purchase                 15Sep Jb Hi Fi Adelaide Ci Adelaide,45,,186264.91,Home & Property,Technology & Appliances
19/09/2022,Visa Purchase                 14Sep Foodworks North Adel North Ade,43.62,,186309.91,Food & Beverage,Food & Groceries
19/09/2022,Osko Withdrawal               19Sep09:46 Final Amount Owed Peter Wenborn,180,,186353.53,Withdrawals & Transfers,Withdrawal
19/09/2022,Osko Withdrawal               18Sep12:16 Payment For Bed Andrew Peter Wenborn,3375,,186533.53,Withdrawals & Transfers,Withdrawal
19/09/2022,Osko Withdrawal               17Sep22:35 Rashins Chance,1500,,189908.53,Withdrawals & Transfers,Withdrawal
17/09/2022,Visa Purchase                 15Sep City Bbq & Yum Cha P Sa Sa,16,,191408.53,Food & Beverage,Dining out
17/09/2022,Annual Package Fee  506149558 Advantage,395,,191424.53,Fees & Charges,Fees & Charges
16/09/2022,Visa Purchase                 13Sep Gondola Gondola      Adelaide,113,,191819.53,Food & Beverage,Dining out
16/09/2022,Visa Purchase                 14Sep Raa                  Mile End,65.41,,191932.53,Transport & Travel,Vehicle Expenses
16/09/2022,Visa Purchase                 14Sep Bws/123 Oconnell Str Nrth Adel,45,,191997.94,Food & Beverage,Beverages
16/09/2022,Visa Purchase                 12Sep Foodworks North Adel North Ade,11.08,,192042.94,Food & Beverage,Food & Groceries
16/09/2022,Property Managme Rent,,1144.52,192054.02,Deposits,Deposit
16/09/2022,Loan Repayment S.514.2655406.00,3673,,190909.5,Home & Property,Mortgage & Rent
15/09/2022,American Express 376012649071009,1506.95,,194582.5,Bills & Payments,Expenses & Payments
15/09/2022,Osko Deposit                  15Sep18:08 Loan  Courtney A Girdler,,350,196089.45,Deposits,Deposit
15/09/2022,Cardless Atm Withdrawal       15Sep09:07 Rundle Place Os          Adelaide     Au,500,,195739.45,Withdrawals & Transfers,ATM & EFTPOS
14/09/2022,Visa Purchase                 11Sep Nth Adel Foodland    North Ade,68.41,,196239.45,Food & Beverage,Food & Groceries
14/09/2022,Visa Purchase                 10Sep Wellington Hotel     North Ade,27,,196307.86,Food & Beverage,Beverages
14/09/2022,Visa Purchase                 12Sep Liquorland 6078      Adelaide,23,,196334.86,Food & Beverage,Beverages
14/09/2022,Visa Purchase                 12Sep Funk Coffee And Food Adelaide,6,,196357.86,Food & Beverage,Beverages
14/09/2022,Visa Purchase                 12Sep Nth Adel Foodland    North Ade,5.15,,196363.86,Food & Beverage,Food & Groceries
14/09/2022,Osko Withdrawal               14Sep21:13 Stuff Chance,750,,196369.01,Withdrawals & Transfers,Withdrawal
14/09/2022,Osko Withdrawal               14Sep21:11 Rent Community Chest,750,,197119.01,Withdrawals & Transfers,Withdrawal
14/09/2022,Osko Withdrawal               14Sep21:00 K Bond,1300,,197869.01,Withdrawals & Transfers,Withdrawal
14/09/2022,Eftpos Debit                  14Sep13:56 Beem It\,200,,199169.01,Withdrawals & Transfers,Funds transfer
13/09/2022,Visa Purchase                 11Sep Bws/123 Oconnell Str Nrth Adel,33,,199369.01,Food & Beverage,Beverages
13/09/2022,Visa Purchase                 10Sep Alh Venues/123 Oconn Nrth Adel,17.8,,199402.01,Transport & Travel,Hotels and Accommodation
13/09/2022,Visa Purchase                 10Sep Alh Venues/123 Oconn Nrth Adel,13.6,,199419.81,Transport & Travel,Hotels and Accommodation
12/09/2022,Visa Purchase                 09Sep Rerun Books Music    Adelaide,65,,199433.41,Retail & Personal,Retail (shopping)
10/09/2022,Visa Purchase                 09Sep Medibank Phi Debit   Melbourne,521,,199498.41,Bills & Payments,Insurance
10/09/2022,Visa Purchase                 08Sep Myrepublic           612831768,107,,200019.41,Bills & Payments,Telecommunications
10/09/2022,Visa Purchase                 08Sep City Bbq & Yum Cha P Sa Sa,16,,200126.41,Food & Beverage,Dining out
10/09/2022,Visa Purchase                 08Sep Independent 132211   Torrensvi,12.45,,200142.41,Transport & Travel,Taxi & Rental car
10/09/2022,Visa Purchase                 08Sep Funk Coffee And Food Adelaide,6,,200154.86,Food & Beverage,Beverages
9/09/2022,Visa Purchase                 06Sep Oxford Hotel         North Ade,10,,200160.86,Food & Beverage,Dining out
9/09/2022,Visa Purchase                 07Sep Funk Coffee And Food Adelaide,6,,200170.86,Food & Beverage,Beverages
9/09/2022,Eftpos Debit                  09Sep21:07 Beem It\,200,,200176.86,Withdrawals & Transfers,Funds transfer
9/09/2022,Osko Withdrawal               09Sep11:08 Invoice 1307 As Per Invoice Number 1 Nat,10610.39,,200376.86,Withdrawals & Transfers,Withdrawal
8/09/2022,Visa Purchase                 06Sep V/Cellars 3327       N Adelaid,42,,210987.25,Food & Beverage,Beverages
8/09/2022,Visa Purchase                 06Sep Raa                  Mile End,20.83,,211029.25,Transport & Travel,Vehicle Expenses
8/09/2022,Visa Purchase                 06Sep Tynte Street Quality North Ade,16.6,,211050.08,Food & Beverage,Food & Groceries
8/09/2022,Visa Purchase                 06Sep Pasta Deli Norwood   Norwood,14.4,,211066.68,Food & Beverage,Dining out
8/09/2022,Visa Purchase                 06Sep Nth Adel Foodland    North Ade,11.28,,211081.08,Food & Beverage,Food & Groceries
8/09/2022,Visa Purchase                 06Sep Funk Coffee And Food Adelaide,6,,211092.36,Food & Beverage,Beverages
8/09/2022,Atm Withdrawal                08Sep06:52 Banksa                Adelaide     5  Au,2000,,211098.36,Withdrawals & Transfers,ATM & EFTPOS
7/09/2022,Visa Purchase                 05Sep Bws Liquor/76 Prospe Prospect,60,,213098.36,Food & Beverage,Beverages
7/09/2022,Visa Purchase                 04Sep Nth Adel Foodland    North Ade,53.38,,213158.36,Food & Beverage,Food & Groceries
7/09/2022,Visa Purchase                 05Sep Funk Coffee And Food Adelaide,11,,213211.74,Food & Beverage,Beverages
7/09/2022,Osko Withdrawal               07Sep13:59 Ada Oliver Dearman,100,,213222.74,Withdrawals & Transfers,Withdrawal
7/09/2022,Atm Withdrawal                07Sep06:23 Banksa                Adelaide     5  Au,2000,,213322.74,Withdrawals & Transfers,ATM & EFTPOS
6/09/2022,Visa Purchase                 02Sep Pastoral Hotel Motel Port Augu,287.98,,215322.74,Transport & Travel,Hotels and Accommodation
6/09/2022,Visa Purchase                 01Sep Pastoral Hotel Motel Port Augu,59.98,,215610.72,Transport & Travel,Hotels and Accommodation
6/09/2022,Visa Purchase                 02Sep Pastoral Hotel Motel Port Augu,30.5,,215670.7,Transport & Travel,Hotels and Accommodation
6/09/2022,Visa Purchase                 02Sep Pastoral Hotel Motel Port Augu,10,,215701.2,Transport & Travel,Hotels and Accommodation
5/09/2022,Visa Purchase                 01Sep L.H. Perry & Sons Pt Snowtown,12.98,,215711.2,Transport & Travel,Petrol
5/09/2022,Internet Deposit              04Sep08:51 From 9000204517840,,2000,215724.18,Deposits,Deposit
3/09/2022,Visa Purchase                 31Aug Drs Hotels Pty Ltd   Adelaide,6.5,,213724.18,Food & Beverage,Beverages
2/09/2022,Visa Purchase                 31Aug Cry Baby Bar         Adelaide,16.18,,213730.68,Food & Beverage,Beverages
2/09/2022,Visa Purchase                 31Aug Cry Baby Bar         Adelaide,12.14,,213746.86,Food & Beverage,Beverages
2/09/2022,Visa Purchase                 31Aug Cry Baby Bar         Adelaide,10.11,,213759,Food & Beverage,Beverages
2/09/2022,Visa Purchase                 31Aug Cry Baby Bar         Adelaide,10.11,,213769.11,Food & Beverage,Beverages
2/09/2022,Visa Purchase                 31Aug Cry Baby Bar         Adelaide,6.07,,213779.22,Food & Beverage,Beverages
2/09/2022,Visa Purchase                 31Aug Funk Coffee And Food Adelaide,6,,213785.29,Food & Beverage,Beverages
2/09/2022,Visa Purchase                 31Aug Otr Pulteney Street  Adelaide,5.79,,213791.29,Transport & Travel,Petrol
2/09/2022,Eftpos Debit                  02Sep17:55 Beem It\,500,,213797.08,Withdrawals & Transfers,Funds transfer
2/09/2022,Internet Withdrawal           02Sep17:30 To 0280074830940,2500,,214297.08,Withdrawals & Transfers,Funds transfer
1/09/2022,Visa Purchase                 30Aug City Bbq & Yum Cha P Sa Sa,19.2,,216797.08,Food & Beverage,Dining out
1/09/2022,Visa Purchase                 30Aug Shijia Service Pty L Adelaide,11.7,,216816.28,Food & Beverage,Food & Groceries
1/09/2022,Visa Purchase                 30Aug Funk Coffee And Food Adelaide,6,,216827.98,Food & Beverage,Beverages
1/09/2022,Medibank Private 600017928019,,226.5,216833.98,Deposits,Insurance
1/09/2022,Osko Withdrawal               01Sep18:52 James Kennedy,300,,216607.48,Withdrawals & Transfers,Withdrawal
1/09/2022,Osko Withdrawal               01Sep10:17 Sexhibition Andrew & Kelly Sexhibit Trh,100,,216907.48,Withdrawals & Transfers,Withdrawal
31/08/2022,Overseas Withdrawal Fee,5,,217007.48,Fees & Charges,Fees & Charges
31/08/2022,Visa Purchase                 27Aug Adelaide Oval Sma    North Ade,46.4,,217012.48,Bills & Payments,Expenses & Payments
31/08/2022,Visa Purchase                 29Aug Raa                  Mile End,40.16,,217058.88,Transport & Travel,Vehicle Expenses
31/08/2022,Visa Purchase                 29Aug Raa                  Mile End,15.66,,217099.04,Transport & Travel,Vehicle Expenses
31/08/2022,Visa Purchase                 29Aug Funk Coffee And Food Adelaide,11,,217114.7,Food & Beverage,Beverages
31/08/2022,Property Managme Rent,,1122.52,217125.7,Deposits,Deposit
30/08/2022,Atm Withdrawal                30Aug11:44 Rundle Place Os          Adelaide     Au,1000,,216003.18,Withdrawals & Transfers,ATM & EFTPOS
29/08/2022,Visa Purchase                 25Aug Jb Hi Fi Adelaide Ci Adelaide,321,,217003.18,Home & Property,Technology & Appliances
29/08/2022,Visa Purchase                 25Aug Dit - Ezyreg         Adelaide,195.13,,217324.18,Transport & Travel,Vehicle Expenses
29/08/2022,Visa Purchase                 26Aug North Adelaide Fitne East Hill,25.9,,217519.31,Retail & Personal,Health & Fitness
29/08/2022,Visa Purchase                 26Aug Otr Prospect 5951    Prospect,11.58,,217545.21,Transport & Travel,Petrol
27/08/2022,Visa Purchase                 25Aug City Bbq & Yum Cha P Sa Sa,16,,217556.79,Bills & Payments,Expenses & Payments
26/08/2022,Visa Purchase                 24Aug Liquorland 6078      Adelaide,28,,217572.79,Food & Beverage,Beverages
26/08/2022,Visa Purchase                 22Aug Caltex North Adelaid North Ade,7.8,,217600.79,Transport & Travel,Petrol
26/08/2022,Visa Purchase                 24Aug Funk Coffee And Food Adelaide,6,,217608.59,Food & Beverage,Beverages
25/08/2022,Visa Purchase                 22Aug Drs Hotels Pty Ltd   Adelaide,30.99,,217614.59,Bills & Payments,Expenses & Payments
25/08/2022,Visa Purchase                 21Aug Caltex North Adelaid North Ade,17,,217645.58,Transport & Travel,Petrol
25/08/2022,Visa Purchase                 22Aug Bank St Conveniece S Adelaide,3.5,,217662.58,Bills & Payments,Expenses & Payments
25/08/2022,Eftpos Debit                  25Aug18:57 Beem It\,100,,217666.08,Withdrawals & Transfers,Funds transfer
24/08/2022,Visa Purchase                 20Aug Myrepublic           612831768,108.33,,217766.08,Bills & Payments,Expenses & Payments
24/08/2022,Visa Purchase                 22Aug Optus Billing Autopa Macquarie,85.75,,217874.41,Bills & Payments,Telecommunications
24/08/2022,Visa Purchase                 22Aug Nth Adel Foodland    North Ade,29.51,,217960.16,Food & Beverage,Food & Groceries
24/08/2022,Visa Purchase                 22Aug Gt & Hg Pty Ltd      North Ade,25.72,,217989.67,Bills & Payments,Expenses & Payments
24/08/2022,Visa Purchase                 22Aug Bws/123 Oconnell Str Nrth Adel,25,,218015.39,Bills & Payments,Expenses & Payments
24/08/2022,Visa Purchase                 20Aug Caledonian Hotel Nor North Ade,20.6,,218040.39,Bills & Payments,Expenses & Payments
24/08/2022,Atm Withdrawal                24Aug15:04 Rundle Place Os          Adelaide     Au,1000,,218060.99,Withdrawals & Transfers,ATM & EFTPOS
23/08/2022,Visa Purchase                 20Aug Gsh Union Pty Ltd    North Ade,24.95,,219060.99,Bills & Payments,Expenses & Payments
23/08/2022,Ozforex Limited Offset,,28360,219085.94,Deposits,Deposit
22/08/2022,Allianz Aust 1Rd221368013822234,129.35,,190725.94,Bills & Payments,Insurance
22/08/2022,Allianz Aust 1Rd220985013822234,19.44,,190855.29,Bills & Payments,Insurance
22/08/2022,Atm Withdrawal                22Aug08:17 Rundle Place Os          Adelaide     Au,2000,,190874.73,Withdrawals & Transfers,ATM & EFTPOS
20/08/2022,Visa Purchase                 17Aug Beem It              Beem.Com.,200,,192874.73,Home & Property,Services & Tradespeople
20/08/2022,Visa Purchase                 17Aug Cafe Fellini         North Ade,19.9,,193074.73,Food & Beverage,Dining out
20/08/2022,Visa Purchase                 16Aug Caltex North Adelaid North Ade,5.2,,193094.63,Transport & Travel,Petrol
19/08/2022,Visa Purchase                 17Aug Tynte Flowers        Hindmarsh,53.5,,193099.83,Retail & Personal,Retail (shopping)
19/08/2022,Visa Purchase                 17Aug Dangerfield          613942900,37.35,,193153.33,Retail & Personal,Clothing & Shoes
19/08/2022,Visa Purchase                 17Aug Smgb Grenfell St     Adelaide,7.5,,193190.68,Bills & Payments,Gifts & Donations
19/08/2022,Visa Purchase                 17Aug Otr Pulteney Street  Adelaide,5.79,,193198.18,Transport & Travel,Petrol
19/08/2022,Visa Purchase                 17Aug Sq *Dayjob           Adelaide,4.5,,193203.97,Food & Beverage,Food & Groceries
18/08/2022,Visa Purchase                 16Aug Bws/123 Oconnell Str Nrth Adel,53,,193208.47,Food & Beverage,Beverages
18/08/2022,Atm Withdrawal                18Aug08:47 Rundle Place Os          Adelaide     Au,550,,193261.47,Withdrawals & Transfers,ATM & EFTPOS
18/08/2022,Cardless Atm Withdrawal       18Aug08:45 Rundle Place Os          Adelaide     Au,50,,193811.47,Withdrawals & Transfers,ATM & EFTPOS
17/08/2022,Visa Purchase                 15Aug Raa                  Mile End,65.41,,193861.47,Transport & Travel,Vehicle Expenses
17/08/2022,Visa Purchase                 15Aug Otr Prospect 5951    Prospect,13.91,,193926.88,Transport & Travel,Petrol
16/08/2022,American Express 376012649071009,1273.8,,193940.79,Bills & Payments,Expenses & Payments
16/08/2022,Foreign Currency Conversn Fee,1.79,,195214.59,Fees & Charges,Fees & Charges
16/08/2022,Visa Cash Advance             14Aug Sgd58.00 Ocbc-Holland V Branc,59.73,,195216.38,Withdrawals & Transfers,Funds transfer
16/08/2022,Foreign Currency Conversn Fee,0.58,,195276.11,Fees & Charges,Fees & Charges
16/08/2022,Visa Purchase O/Seas          13Aug Sgd18.90 7-Eleven-The Quaysid,19.46,,195276.69,Food & Beverage,Food & Groceries
16/08/2022,Foreign Currency Conversn Fee,0.21,,195296.15,Fees & Charges,Fees & Charges
16/08/2022,Visa Purchase O/Seas          13Aug Sgd6.90 7-Eleven-The Quaysid,7.11,,195296.36,Food & Beverage,Food & Groceries
16/08/2022,Loan Repayment S.514.2655406.00,3469,,195303.47,Home & Property,Mortgage & Rent
15/08/2022,Foreign Currency Conversn Fee,0.81,,198772.47,Fees & Charges,Fees & Charges
15/08/2022,Visa Purchase O/Seas          12Aug Sgd26.30 7-Eleven-The Quaysid,27.17,,198773.28,Food & Beverage,Food & Groceries
15/08/2022,Visa Purchase                 12Aug North Adelaide Fitne East Hill,25.9,,198800.45,Retail & Personal,Health & Fitness
15/08/2022,Visa Purchase                 11Aug Relay Cafe           Adelaide,12.63,,198826.35,Food & Beverage,Dining out
15/08/2022,Foreign Currency Conversn Fee,0.36,,198838.98,Fees & Charges,Fees & Charges
15/08/2022,Visa Purchase O/Seas          12Aug Sgd11.90 7-Eleven-Lubritrade,12.29,,198839.34,Food & Beverage,Food & Groceries
15/08/2022,Property Managme Rent,,2289.04,198851.63,Deposits,Deposit
12/08/2022,Foreign Currency Conversn Fee,4.31,,196562.59,Fees & Charges,Fees & Charges
12/08/2022,Visa Purchase O/Seas          10Aug Usd99.99 Samharris.Org,143.85,,196566.9,Home & Property,Technology & Appliances
12/08/2022,Visa Purchase                 10Aug City Bbq & Yum Cha P Sa Sa,16,,196710.75,Food & Beverage,Dining out
12/08/2022,Visa Purchase                 09Aug Nth Adel Foodland    North Ade,11.8,,196726.75,Food & Beverage,Food & Groceries
11/08/2022,Visa Purchase                 09Aug V/Cellars 3327       N Adelaid,24,,196738.55,Food & Beverage,Beverages
11/08/2022,Visa Purchase                 07Aug Foodworks North Adel North Ade,22.8,,196762.55,Food & Beverage,Food & Groceries
11/08/2022,Visa Purchase                 07Aug Foodworks North Adel North Ade,9.98,,196785.35,Food & Beverage,Food & Groceries
10/08/2022,Visa Purchase                 09Aug Medibank Phi Debit   Melbourne,521,,196795.33,Bills & Payments,Insurance
10/08/2022,Visa Purchase                 08Aug Myrepublic           612831768,107,,197316.33,Bills & Payments,Telecommunications
10/08/2022,Visa Purchase                 05Aug Adult Superstore     Adelaide,104,,197423.33,Bills & Payments,Gifts & Donations
10/08/2022,Visa Purchase                 08Aug Raa                  Mile End,20.83,,197527.33,Transport & Travel,Vehicle Expenses
10/08/2022,Visa Purchase                 07Aug Blue And White Cafe  North Ade,13,,197548.16,Food & Beverage,Dining out
10/08/2022,Visa Purchase                 07Aug Bakery On O'Connell  North Ade,11.3,,197561.16,Food & Beverage,Food & Groceries
10/08/2022,Cardless Atm Withdrawal       10Aug13:24 Rundle Place Os          Adelaide     Au,150,,197572.46,Withdrawals & Transfers,ATM & EFTPOS
10/08/2022,Osko Deposit                  10Aug13:03 Loan  Courtney Anne Girdler Sweet Image,,350,197722.46,Deposits,Deposit
9/08/2022,Visa Purchase                 07Aug Bws/123 Oconnell Str Nrth Adel,92,,197372.46,Food & Beverage,Beverages
8/08/2022,Visa Purchase                 05Aug Gi Media             Cleveland,10,,197464.46,Bills & Payments,Expenses & Payments
8/08/2022,Osko Withdrawal               08Aug11:16 220048 For The Account Of Mr L Spencer G,1391.28,,197474.46,Withdrawals & Transfers,Withdrawal
6/08/2022,Visa Purchase                 02Aug Foodworks North Adel North Ade,33.67,,198865.74,Food & Beverage,Food & Groceries
5/08/2022,Visa Purchase                 03Aug Coles 0429           Welland,87.36,,198899.41,Food & Beverage,Food & Groceries
5/08/2022,Visa Purchase                 03Aug Coles 4964           Adelaide,7.55,,198986.77,Food & Beverage,Food & Groceries
5/08/2022,Visa Purchase                 01Aug Caltex North Adelaid North Ade,5.2,,198994.32,Transport & Travel,Petrol
5/08/2022,Cardless Atm Withdrawal       05Aug14:11 Banksa                Adelaide     5  Au,400,,198999.52,Withdrawals & Transfers,ATM & EFTPOS
5/08/2022,Osko Withdrawal               05Aug12:31 Tnite K Bond,50,,199399.52,Withdrawals & Transfers,Withdrawal
5/08/2022,Eftpos Debit                  05Aug12:16 Beem It\,50,,199449.52,Withdrawals & Transfers,Funds transfer
4/08/2022,Visa Purchase                 02Aug Nth Adel Foodland    North Ade,68.08,,199499.52,Food & Beverage,Food & Groceries
4/08/2022,Visa Purchase                 02Aug Liquorland 6078      Adelaide,30,,199567.6,Food & Beverage,Beverages
4/08/2022,Visa Purchase                 01Aug Oxford Hotel         North Ade,17,,199597.6,Food & Beverage,Dining out
4/08/2022,Visa Purchase                 02Aug Hungry Jacks         Adelaide,13.5,,199614.6,Food & Beverage,Dining out
4/08/2022,Visa Purchase                 02Aug Shijia Service Pty L Adelaide,8.5,,199628.1,Food & Beverage,Food & Groceries
4/08/2022,Osko Withdrawal               04Aug16:02 3870 Deposit For Insulation Cosywrap,371,,199636.6,Withdrawals & Transfers,Withdrawal
3/08/2022,Visa Purchase                 01Aug V/Cellars 3327       N Adelaid,92,,200007.6,Food & Beverage,Beverages
3/08/2022,Visa Purchase                 01Aug Jeff Ramsey Pharmaci North Ade,76.55,,200099.6,Retail & Personal,Medical & Personal care
3/08/2022,Visa Purchase                 01Aug Nth Adel Foodland    North Ade,30.55,,200176.15,Food & Beverage,Food & Groceries
3/08/2022,Visa Purchase                 31Jul Bakery On O'Connell  North Ade,17.7,,200206.7,Food & Beverage,Food & Groceries
3/08/2022,Atm Withdrawal                03Aug07:22 Rundle Place Os          Adelaide     Au,2000,,200224.4,Withdrawals & Transfers,ATM & EFTPOS
2/08/2022,Visa Purchase                 29Jul Oxford Hotel         North Ade,21.5,,202224.4,Food & Beverage,Dining out
2/08/2022,Visa Purchase                 29Jul Oxford Hotel         North Ade,17,,202245.9,Food & Beverage,Dining out
2/08/2022,Visa Purchase                 29Jul Bakery On O'Connell  North Ade,12.6,,202262.9,Food & Beverage,Food & Groceries
2/08/2022,Visa Purchase                 30Jul Gi Media             Cleveland,10,,202275.5,Bills & Payments,Expenses & Payments
2/08/2022,Visa Purchase                 29Jul Oxford Hotel         North Ade,8,,202285.5,Food & Beverage,Dining out
2/08/2022,Visa Purchase                 29Jul Oxford Hotel         North Ade,8,,202293.5,Food & Beverage,Dining out
2/08/2022,Visa Purchase                 29Jul Oxford Hotel         North Ade,8,,202301.5,Food & Beverage,Dining out
2/08/2022,Atm Withdrawal                02Aug07:36 Banksa                Adelaide     5  Au,2000,,202309.5,Withdrawals & Transfers,ATM & EFTPOS
1/08/2022,Visa Purchase                 29Jul Woolworths/80-88 Run Rundle Ma,79,,204309.5,Food & Beverage,Food & Groceries
1/08/2022,Visa Purchase                 29Jul Raa                  Mile End,40.16,,204388.5,Transport & Travel,Vehicle Expenses
1/08/2022,Visa Purchase                 29Jul North Adelaide Fitne East Hill,25.9,,204428.66,Retail & Personal,Health & Fitness
1/08/2022,Visa Purchase                 29Jul Raa                  Mile End,15.66,,204454.56,Transport & Travel,Vehicle Expenses
30/07/2022,Overseas Withdrawal Fee,10,,204470.22,Fees & Charges,Fees & Charges
30/07/2022,Visa Purchase                 27Jul Giga Pty Limited     Sydney,65,,204480.22,Retail & Personal,Retail (shopping)
30/07/2022,Visa Purchase                 28Jul Coles 4964           Adelaide,12.8,,204545.22,Food & Beverage,Food & Groceries
30/07/2022,Internet Withdrawal           29Jul23:08 To 0280074830940,6000,,204558.02,Withdrawals & Transfers,Funds transfer
29/07/2022,Visa Purchase                 27Jul Adelaide Health Care Adelaide,86.35,,210558.02,Retail & Personal,Medical & Personal care
